Dd, Dd, Dd, Dd, Dd, Dd, Dd, Dd, Dd, Dd, Dd, Dd, Dd, Dd, Dd, Dd, Dd
Dd, Dd, Dd, Dd^Dc, Dd, Dd, Dd, Dd, Dd, Dd, Dd, Dd, Dd, Dd, Dd, Dd^Dc, Dd
Dd, Dd, Dd^Edp, Dd, Dd, Dd, Dd, Dd, Dd, Dd, Dd^Esd, Dd, Dd, Dd, Dd, Dd, Dd
Dd, Dd, Dd, Dd, Dd, Dd, Dd, Dd^Esd, Dd, Dd^Dc, Dd, Dd, Dd, Dd, Dd, Dd, Dd
Dd, Dd^Dc, Dd^Esd, Dd, Dd, Dd, Dd^Esd, Dd, Dd, Dd, Dd, Dd, Dd, Dd, Dd, Dd, Dd
Dd, Dd, Dd, Dd, Dd, Dd, Dd^Esd, Dd, Dd, Dd, Dd, Dd^Esd, Dd, Dd, Dd, Dd^Edpp, Dd
Dd, Dd, Dd, Dd, Dd^Esd, Dd, Dd, Dd, Dd, Dd^Esd, Dd, Dd, Dd, Dd, Dd^Esd, Dd, Dd
Dd, Dd^Edpp, Dd, Dd, Dd, Dd, Dd, Dd^Esd, Dd, Dd, Dd^Dc, Dd, Dd, Dd^Esd, Dd^Ftd, Dd^Ftd, Dd^Em
Dd, Dd, Dd, Dd, Dd, Dd, Dd, Dd, Dd, Dd, Dd, Dd, Dd, Dd, Dd^Ftd, Dd^Do, Dd^Ftd
Dd, Dd, Dd, Dd, Dd, Dd, Dd^Esd, Dd, Dd^Esd, Dd, Dd, Dd, Dd, Dd, Dd, Dd^Ftd, Dd^Ftd
Dd, Dd^Edp, Dd, Dd^Dc, Dd, Dd, Dd, Dd, Dd, Dd^Esd, Dd^Esd, Dd, Dd, Dd^Es, Dd, Dd, Dd^Es
Dd, Dd, Dd, Dd, Dd, Dd, Dd, Dd^Esd, Dd, Dd, Dd, Dd, Hd, Dd, Dd, Dd^Es, Dd
