Gg, Gg, Gg, Gg, Gg, Gg, Gg, Gg, Gg, Gg, Gg, Gg, Gg, Gg, Gg, Gg, Gg, Gg, Gg, Gg, Gg, Gg, Gg, Gg, Gg, Gg, Gg, Gg, Gg, Gg, Gg, Gg, Gg, Gg, Gg, Gg, Gg, Gg, Gg, Gg, Gg, Gg, Gg, Gg, XUrb, XUrb, XUrb, XUrb, XUrb, Gd, Gd, Xoc, Xoc, Iwr, Iwr, Iwr, Xoc, Xoc, Xoc, Iwr, Xoc, Xoc, Gd, Gd, XUrb, XUrb, XUrb, XUrb, XUrb, XUrb, Gd^Eff, XUrb, XUrb, XUrb, XUrb, XUrb, XUrb
Gg, Gg, Gg, Gg, Gg, Gg, Gg, Gg, Gg, Gg, Gg, Gg, Gg, Gg, Gg, Gg, Gg, Gg, Gg, Gg, Gg, Gg, Gg, Gg, Gg, Gg, Gg, Gg, Gg, Gg, Gg, Gg, Gg, Gg, Gg, Gg, Gg, Gg, Gg, Gg, Gg, Gg, Gd^Fts, Gd, Gd, XUrb, XUrb, XUrb, XUrb, XUrb, XUrb, Gd, Gd, Xoc, Xoc, Xoc, Gs^Ftp, Gs^Ftp, Gs^Ftp, Xoc, Gd, Gd, XUrb, XUrb, XUrb, XUrb, XUrb, XUrb, Gd^Eff, Gd^Eff, Gd, Gd^Eff, Gd^Eff, XUrb, XUrb, XUrb, XUrb
Gg, Gg, Gg, Gg, Gg, Gg, Gg, Gg, Gg, Gg, Gg, Gg, Gg, Gg, Gg, Gg, Gg, Gg, Gg, Gg, Gg, Gg, Gg, Gg, Gg, Gg, Gg, Gg, Gg, Gg, Gg, Gg, Gg, Gg, Gg, Gg, Gg, Gg, Gg, Gg, Gd^Fts, Gd^Fts, Xoc, Xoc, Xoc, Gd, Gd, XUrb, XUrb, XUrb, XUrb, XUrb, XUrb, Gd, Gd, Gd^Ftp, Gd^Fts, Gd^Fts, Gd, Gd, XUrb, XUrb, XUrb, XUrb, XUrb, XUrb, Xoc, Gd^Ftp, Gd^Eaz, Gd, Gs^Ftp, Gs^Fts, Gs^Fts, Gd^Eff, Gd^Eff, XUrb, XUrb
Gg, Gg, Gg, Gg, Gg, Gg, Gg, Gg, Gg, Gg, Gg, Gg, Gg, Gg, Gg, Gg, Gg, Gg, Gg, Gg, Gg, Gg, Gg, Gg, Gg, Gg, Gg, Gg, Gg, Gg, Gg, Gg, Gg, Gg, Gg, Gg, Gd^Fts, Gd^Fts, Gd^Fts, Gd^Fts, Xoc, Xoc, Iwr, Iwr, Iwr, Xoc, Xoc, Gd, Gd, XUrb, XUrb, XUrb, XUrb, XUrb, XUrb, Gd, Gd, Gd, XUrb, XUrb, XUrb, XUrb, XUrb, XUrb, Xoc, Xoc, Iwr, Xoc, Xoc, Gd, Gd, Gs^Ftp, Gd, Gd, Gd, Gd^Eff, XUrb^Eff
Gg, Gg, Gg, Gg, Gg, Gg, Gg, Gg, Gg, Gg, Gg, Gg, Gg, Gg, Gg, Gg, Gg, Gg, Gg, Gg, Gg, Gg, Gg, Gg, Gg, Gg, Gg, Gg, Gg, Gg, Gg, Gg, Gg, Gg, Gd^Fts, Gd^Fts, Gd^Ftp, Gd^Ftp, Xoc, Xoc, Iwr, Iwr, Iwr, Iwr, Iwr, Iwr, Iwr, Xoc, Xoc, Gd, Gd, XUrb, XUrb, XUrb, XUrb, XUrb, XUrb, XUrb, XUrb, XUrb, XUrb, XUrb, Gd, Gd, Xoc, Iwr, Iwr, Iwr, Iwr, Rr^Pw\, Xoc, Gd, Gd^Ebz, Gd, Gd^Eff, Gd^Eff, Gd
Gg, Gg, Gg, Gg, Gg, Gg, Gg, Gg, Gg, Gg, Gg, Gg, Gg, Gg, Gg, Gg, Gg, Gg, Gg, Gg, Gg, Gg, Gg, Gg, Gg, Gg, Gg, Gg, Gg, Gg, Gg, Gg, Gg^Fts, Gd^Fts, Gd^Ftp, Gd^Ftp, Gd^Eff, Gd^Eff, Xoc, Iwr, Iwr, Iwr, Iwr, Iwr, Iwr, Iwr, Iwr, Iwr, Iwr, Xoc, Xoc, Gd, Gd, XUrb, XUrb, XUrb, XUrb, XUrb, XUrb, XUrb, Gd, Gd, Gd^Ft, Gd^Ft, Xoc, Iwr, Iwr, Iwr, Iwr, Iwr, Iwr, Xoc, Xoc, Gd^Eff, Gd, Gd, Gd
Gg, Gg, Gg, Gg, Gg, Gg, Gg, Gg, Gg, Gg, Gg, Gg, Gg, Gg, Gg, Gg, Gg, Gg, Gg, Gg, Gg, Gg, Gg, Gg, Gg, Gg, Gg, Gg, Gg, Gg, Gd, Gd^Fts, Gd^Ftp, Gd^Ftp, Gd^Eff, Gd^Eff, Gd^Efm, Gd^Efm, Gd, Rr^Pw\, Xoc, Iwr, Iwr, Iwr, Iwr, Iwr, Iwr, Iwr, Iwr, Iwr, Iwr, Xoc, Xoc, Gd, Gd, XUrb, XUrb, XUrb, Gd, Gd, Gd^Ft, Gd^Ft, Xoc, Xoc, Iwr, Xoc, Rr^Pw\, Iwr, Iwr, Iwr, Iwr, Iwr, Xoc, Gd, Gd, Gd, XUrb
Gg, Gg, Gg, Gg, Gg, Gg, Gg, Gg, Gg, Gg, Gg, Gg, Gg, Gg, Gg, Gg, Gg, Gg, Gg, Gg, Gg, Gg, Gg, Gg, Gg, Gg, Gg, Gg, Gd, Gd, Gd^Fts, Gd^Ftp, Gd^Eff, Gd^Eff, Gd^Efm, Gd^Efm, Gd, Gd, Gd^Egz, Gd, Gd, Xoc, Xoc, Iwr, Iwr, Iwr, Iwr, Iwr, Iwr, Iwr, Iwr, Iwr, Xoc, Gd^Ft, Gd, XUrb, XUrb, XUrb, Gd^Fts, Gd^Ft, Xoc, Xoc, Iwr, Iwr, Iwr, Iwr, Iwr, Xoc, Xoc, Iwr, Xoc, Xoc, Gd^Fts, Gd^Fts, XUrb, XUrb, XUrb
Gg, Gg, Gg, Gg, Gg, Gg, Gg, Gg, Gg, Gg, Gg, Gg, Gg, Gg, Gg, Gg, Gg, Gg, Gg, Gg, Gg, Gg, Gg, Gg, Gg, Gg, Gd, Gd, Gd^Fts, Gd^Fts, Xoc, Xoc, Xoc, Gd^Efm, Gd, Gd, Gd^Egz, Gd, Gd, Gd, Gd, Gd^Ebn, Xoc, Xoc, Xoc, Iwr, Iwr, Iwr, Iwr, Iwr, Xoc, Xoc, Gd^Ft, Gd^Ft, Gd, XUrb, XUrb, XUrb, Xoc, Xoc, Iwr, Iwr, Iwr, Iwr, Iwr, Iwr, Iwr, Iwr, Xoc, Xoc, Gd^Fts, Gd^Fts, XUrb, XUrb, XUrb, XUrb, Gd^Fts
Gg, Gg, Gg, Gg, Gg, Gg, Gg, Gg, Gg, Gg, Gg, Gg, Gg, Gg, Gg, Gg, Gg, Gg, Gg, Gg, Gg, Gg, Gg, Gg, Gg, Gg, Gd^Fts, Gd^Fts, Xoc, Xoc, Iwr, Iwr, Iwr, Rr^Pw\, Xoc, Gd, Gd, Gd, Gd^Efm, Gd^Efm, Xoc, Xoc, Iwr, Iwr, Iwr, Rr^Pw\, Xoc, Iwr, Xoc, Xoc, Gd^Ft, Gd^Ft, Gd, Gd, XUrb, XUrb, XUrb, XUrb, XUrb, Xoc, Xoc, Iwr, Iwr, Iwr, Iwr, Iwr, Xoc, Xoc, Gd^Fts, Gd^Fts, XUrb, XUrb, XUrb, XUrb, Gd^Fts, Gd^Fts, Xoc
Gg, Gg, Gg, Gg, Gg, Gg, Gg, Gg, Gg, Gg, Gg, Gg, Gg, Gg, Gg, Gg, Gg, Gg, Gg, Gg, Gg, Gg, Gg, Gg, Gg, Gg, Xoc, Xoc, Iwr, Iwr, Iwr, Iwr, Iwr, Iwr, Iwr, Xoc, Xoc, Gd^Ebn, Xoc, Xoc, Iwr, Iwr, Iwr, Iwr, Iwr, Iwr, Iwr, Xoc, Xoc, Gd^Ft, Gd, Gd, XUrb, XUrb, XUrb, XUrb, XUrb, XUrb, XUrb, XUrb, XUrb, Xoc, Xoc, Iwr, Xoc, Rr^Pw/, XUrb, Gd^Fts, XUrb, XUrb, XUrb, XUrb, Gd^Fts, Gd^Fts, Xoc, Xoc, Xoc
Gg, Gg, Gg, Gg, Gg, Gg, Gg, Gg, Gg, Gg, Gg, Gg, Gg, Gg, Gg, Gg, Gg, Gg, Gg, Gg, Gg, Gg, Gg, Gg, Gg, Gg, Xoc, Iwr, Iwr, Iwr, Iwr, Iwr, Iwr, Iwr, Iwr, Iwr, Iwr, Xoc, Xoc, Iwr, Iwr, Iwr, Iwr, Iwr, Iwr, Iwr, Xoc, Xoc, XUrb, XUrb, XUrb, XUrb, XUrb, XUrb, XUrb, XUrb, Gd^Fts, Gd^Fts, Gd^Fts, XUrb, XUrb, XUrb, XUrb, Xoc, XUrb, XUrb, XUrb, XUrb, XUrb, XUrb, Gd^Fts, Gd^Fts, Xoc, Xoc, Iwr, Iwr, Iwr
Gg, Gg, Gg, Gg, Gg, Gg, Gg, Gg, Gg, Gg, Gg, Gg, Gg, Gg, Gg, Gg, Gg, Gg, Gg, Gg, Gg, Gg, Gg, Gg, Gg, Gg, Gg, Xoc, Xoc, Iwr, Iwr, Iwr, Iwr, Iwr, Iwr, Iwr, Iwr, Iwr, Iwr, Rr^Pw\, Xoc, Iwr, Iwr, Iwr, Xoc, Rr^Pw/, XUrb, XUrb, XUrb, XUrb, XUrb, XUrb, XUrb, XUrb, XUrb, Gd^Fts, Gd^Fts, Gs^Ft, Gs^Ft, Gd^Fts, Gd^Fts, XUrb, XUrb, XUrb, XUrb, XUrb, XUrb, XUrb, XUrb, XUrb, Rr^Pw/, Xoc, Iwr, Iwr, Iwr, Iwr, Iwr
Gg, Gg, Gg, Gg, Gg, Gg, Gg, Gg, Gg, Gg, Gg, Gg, Gg, Gg, Gg, Gg, Gg, Gg, Gg, Gg, Gg, Gg, Gg, Gg, Gg, Gg, Gg, Gg, Gg, Xoc, Xoc, Iwr, Iwr, Iwr, Iwr, Iwr, Iwr, Iwr, Iwr, Iwr, Xoc, Xoc, Xoc, Xoc, XUrb, XUrb, XUrb, XUrb, XUrb, XUrb, XUrb, XUrb, Xoc, XUrb, XUrb, XUrb, XUrb, Gd^Fts, Gd^Fts, Gs^Ft, Gd^Fts, Gd^Fts, XUrb, XUrb, XUrb, XUrb, XUrb, XUrb, Xoc, Xoc, Iwr, Iwr, Iwr, Iwr, Iwr, Iwr, Iwr
Gg, Gg, Gg, Gg, Gg, Gg, Gg, Gg, Gg, Gg, Gg, Gg, Gg, Gg, Gg, Gg, Gg, Gg, Gg, Gg, Gg, Gg, Gg, Gg, Gg, Gg, Gg, Gg, Gg, Gg, Gg, Xoc, Xoc, Iwr, Iwr, Iwr, Iwr, Iwr, Xoc, Xoc, Gd^Ftp, Gd^Ftp, Gd, XUrb, XUrb, XUrb, XUrb, XUrb, XUrb, XUrb, Xoc, Xoc, Iwr^Eby, Xoc, Xoc, XUrb, XUrb, XUrb, XUrb, Gd^Fts, XUrb, XUrb, XUrb, XUrb, XUrb, XUrb, Xoc, Xoc, Iwr, Iwr, Iwr, Iwr, Iwr, Iwr, Iwr, Iwr, Iwr
Gg, Gg, Gg, Gg, Gg, Gg, Gg, Gg, Gg, Gg, Gg, Gg, Gg, Gg, Gg, Gg, Gg, Gg, Gg, Gg, Gg, Gg, Gg, Gg, Gg, Gg, Gg, Gg, Gg, Gg, Gg, Gg, XUrb, Xoc, Xoc, Iwr, Xoc, Xoc, Gd^Ftp, Gd^Ftp, Gd, Gd, XUrb, XUrb, XUrb, XUrb, XUrb, XUrb, Xoc^Efs, Xoc, Iwr^Ewz, Xoc, Rr^Pw\, Iwr^Eqy, Iwr, Xoc, Xoc, XUrb, XUrb, XUrb, XUrb, XUrb, XUrb, XUrb, XUrb, XUrb, XUrb, Xoc, Xoc, Iwr, Iwr, Iwr, Iwr, Iwr, Iwr, Iwr, Xoc
Gg, Gg, Gg, Gg, Gg, Gg, Gg, Gg, Gg, Gg, Gg, Gg, Gg, Gg, Gg, Gg, Gg, Gg, Gg, Gg, Gg, Gg, Gg, Gg, Gg, Gg, Gg, Gg, Gg, Gg, XUrb, XUrb, XUrb, XUrb, XUrb, Xoc, Gd^Ftp, Gd^Ftp, Gd, Gd, XUrb, XUrb, XUrb, XUrb, XUrb, XUrb, Rr^Pw/o, Xoc, Iwr, Iwr^Ewz, Iwr^Egz, Iwr, Iwr^Ekz, Xoc, Iwr, Iwr^Eay, Xoc, XUrb, XUrb, XUrb, XUrb, XUrb, Gd^Fts, XUrb, XUrb, XUrb, XUrb, XUrb, Xoc, Xoc, Rr^Pw\, Iwr, Iwr, Iwr, Xoc, Xoc, XUrb
Gg, Gg, Gg, Gg, Gg, Gg, Gg, Gg, Gg, Gg, Gg, Gg, Gg, Gg, Gg, Gg, Gg, Gg, Gg, Gg, Gg, Gg, Gg, Gg, Gg, Gg, Gg, Gg, XUrb, XUrb, Gd, XUrb, XUrb, XUrb, XUrb, XUrb, XUrb, Gd, XUrb, XUrb, XUrb, XUrb, XUrb, XUrb, Xoc^Efs, Xoc^Efs, Iwr, Iwr, Iwr, Iwr, Iwr, Iwr^Egz, Iwr^Egz, Xoc, Xoc^Efs, Iwr^Eby, Xoc, XUrb, XUrb, XUrb, XUrb, XUrb, Gd^Fts, Gd^Fts, Gd^Fts, XUrb, XUrb, XUrb, Xoc, Iwr, Iwr, Xoc, Xoc, Xoc, Iwr, Xoc, XUrb
Gg, Gg, Gg, Gg, Gg, Gg, Gg, Gg, Gg, Gg, Gg, Gg, Gg, Gg, Gg, Gg, Gg, Gg, Gg, Gg, Gg, Gg, Gg, Gg, Gg, Gg, XUrb, XUrb, Xoc, Gd^Fts, Gd^Fts, Gd, Gd, XUrb, XUrb, XUrb, XUrb, XUrb, XUrb, XUrb, XUrb, XUrb, Xoc, Xoc, Iwr, Iwr, Iwr^Ebz, Iwr, Iwr, Iwr, Iwr, Iwr, Xoc, Xoc^Efs, Iwr^Egz, Xoc, Xoc, XUrb, XUrb, XUrb, XUrb, XUrb, Gd^Fts, Gs^Ftp, Gd^Fts, XUrb, XUrb, XUrb, XUrb, Xoc, Xoc, Iwr, Iwr, Iwr, Xoc, Xoc, XUrb
Gg, Gg, Gg, Gg, Gg, Gg, Gg, Gg, Gg, Gg, Gg, Gg, Gg, Gg, Gg, Gg, Gg, Gg, Gg, Gg, Gg, Gg, Gg, Gg, XUrb, XUrb, Xoc, Xoc, Iwr, Xoc, Xoc, Xoc, Xoc, XUrb, XUrb, XUrb, XUrb, XUrb, XUrb, XUrb, XUrb, Gd, Xoc, Iwr, Iwr^Ebz, Iwr^Ebz, Iwr, Iwr, Iwr^Ebz, Iwr, Iwr, Iwr, Iwr^Eaz, Iwr, Iwr, Iwr^Ekz, Iwr, Rr^Pw\o, Xoc^Efs, XUrb, XUrb, XUrb, XUrb, Gd^Fts, Gd^Fts, XUrb, XUrb, XUrb, XUrb, XUrb, XUrb, Xoc, Xoc, Xoc, XUrb, XUrb, XUrb
Gg, Gg, Gg, Gg, Gg, Gg, Gg, Gg, Gg, Gg, Gg, Gg, Gg, Gg, Gg, Gg, Gg, Gg, Gg, Gg, Gg, Gg, XUrb, XUrb, Xoc, Xoc, Iwr, Iwr, Iwr, Iwr, Iwr, Xoc, Iwr, Rr^Pw\, Xoc, XUrb, XUrb, XUrb, XUrb, XUrb, XUrb, Gd^Ftd, Gd^Ftd, Xoc, Xoc, Iwr, Iwr^Ebz, Iwr^Ebz, Xoc^Efs, Iwr, Iwr^Eaz, Iwr, Iwr, Iwr, Iwr^Eaz, Iwr, Iwr, Iwr, Iwr^Egz, Xoc, XUrb, XUrb, XUrb, XUrb, XUrb, XUrb, XUrb, XUrb, Gd^Fts, XUrb, XUrb, XUrb, XUrb, XUrb, XUrb, XUrb, XUrb
Gg, Gg, Gg, Gg, Gg, Gg, Gg, Gg, Gg, Gg, Gg, Gg, Gg, Gg, Gg, Gg, Gg, Gg, Gg, Gg, Gg, XUrb, Xoc, Xoc, Iwr, Iwr, Iwr, Iwr, Iwr, Iwr, Iwr, Iwr, Iwr, Xoc, Xoc, Xoc, Gd^Fts, Gd, Gd, XUrb, XUrb, XUrb, XUrb, Gd^Ftd, Gd^Ftd, Xoc, Xoc, Xoc^Efs, Iwr^Ebz, Iwr^Ejz, Iwr, Iwr, Iwr^Eaz, Iwr, Iwr, Iwr, Iwr^Ekz, Iwr, Xoc, Xoc, XUrb, XUrb, XUrb, XUrb, XUrb, XUrb, Xoc, Xoc, Xoc, Gd^Fts, Gd^Fts, XUrb, XUrb, XUrb, XUrb, XUrb, XUrb
Gg, Gg, Gg, Gg, Gg, Gg, Gg, Gg, Gg, Gg, Gg, Gg, Gg, Gg, Gg, Gg, Gg, Gg, Gg, Gg, Gg, XUrb, XUrb, Xoc, Xoc, Iwr, Iwr, Iwr, Iwr, Iwr, Iwr, Iwr, Iwr, Iwr, Iwr, Xoc, Xoc, Gd^Fts, Gd^Fts, Gd, Gd, XUrb, XUrb, XUrb, XUrb, Gd^Ftd, Xoc^Efs, Iwr^Ejz, Iwr, Iwr, Iwr^Ebz, Iwr^Ekz, Iwr, Iwr, Iwr, Iwr^Ebz, Xoc^Efs, Xoc, XUrb, XUrb, XUrb, XUrb, XUrb, XUrb, Rr^Pw/, Xoc, Iwr, Iwr, Iwr, Xoc, Xoc, Gd^Fts, Gd^Fts, Gd, Gd^Fts, XUrb, XUrb
Gg, Gg, Gg, Gg, Gg, Gg, Gg, Gg, Gg, Gg, Gg, Gg, Gg, Gg, Gg, Gg, Gg, Gg, Gg, Gg, Gg, Gg, XUrb, XUrb, XUrb, Xoc, Xoc, Iwr, Iwr, Iwr, Iwr, Iwr, Iwr, Iwr, Iwr, Iwr, Xoc, Xoc, Gd^Ftp, Gd^Ftp, Gd, XUrb, XUrb, XUrb, XUrb, XUrb^Efs, XUrb^Efs, Xoc^Efs, Xoc^Efs, Iwr, Iwr, Iwr, Iwr^Ebz, Iwr^Ekz, Xoc^Efs, Xoc^Efs, XUrb, XUrb, XUrb, XUrb, XUrb, XUrb, Xoc, Xoc, Iwr, Iwr, Iwr, Iwr, Iwr, Iwr, Iwr, Xoc, Xoc, Gd^Fts, Xoc, Xoc, Xoc
Gg, Gg, Gg, Gg, Gg, Gg, Gg, Gg, Gg, Gg, Gg, Gg, Gg, Gg, Gg, Gg, Gg, Gg, Gg, Gg, XUrb, XUrb, XUrb, XUrb, XUrb, XUrb, XUrb, Xoc, Xoc, Iwr, Iwr, Iwr, Iwr, Iwr, Xoc, Xoc, Gd^Ftp, Gd^Ftp, Gd, Gd, XUrb, XUrb, XUrb, XUrb, XUrb, XUrb, XUrb, XUrb^Efs, XUrb, Rr^Pw\o, Xoc^Efs, Iwr, Xoc, Xoc, XUrb, XUrb, XUrb, XUrb, XUrb, XUrb, XUrb, Xoc, Xoc, Iwr, Iwr, Iwr, Iwr, Iwr, Iwr, Iwr, Iwr, Iwr, Iwr, Xoc, Iwr, Iwr, Iwr
Gg, Gg, Gg, Gg, Gg, Gg, Gg, Gg, Gg, Gg, Gg, Gg, Gg, Gg, Gg, Gg, Gg, Gg, XUrb, XUrb, Xoc, XUrb, XUrb, XUrb, XUrb, XUrb, XUrb, XUrb, XUrb, Xoc, Xoc, Iwr, Xoc, Xoc, Gd^Ftp, Gd^Ftp, Gd, Gd, XUrb, XUrb, XUrb, XUrb, Gd, Gd, Gll^Eff, XUrb, XUrb, XUrb, XUrb, XUrb^Efs, XUrb^Efs, Xoc^Efs, XUrb, XUrb, XUrb, XUrb, Gd^Fts, Gd^Fts, XUrb, XUrb, XUrb, XUrb, XUrb, Xoc, Xoc, Iwr, Iwr, Iwr, Iwr, Iwr, Iwr, Iwr, Iwr, Iwr, Iwr, Iwr, Xoc
Gg, Gg, Gg, Gg, Gg, Gg, Gg, Gg, Gg, Gg, Gg, Gg, Gg, Gg, Gg, Gg, XUrb, XUrb, Xoc, Xoc, Iwr, Xoc, Xoc, XUrb, XUrb, XUrb, XUrb, XUrb, XUrb, XUrb, XUrb, Xoc, Gd^Ftp, Gd^Ftp, Gd, Gd, XUrb, XUrb, XUrb, XUrb, Gd, Gd, Gll^Eff, Gll^Eff, Gs^Ftp, Gs^Eff, Gs^Eff, XUrb, XUrb, XUrb, XUrb, XUrb, XUrb, XUrb, Gd^Fts, Gd^Fts, XUrb, XUrb, XUrb, XUrb, XUrb, XUrb, XUrb, XUrb, XUrb, Xoc, Xoc, Iwr, Iwr, Iwr, Iwr, Iwr, Iwr, Iwr, Xoc, Xoc, XUrb
Gg, Gg, Gg, Gg, Gg, Gg, Gg, Gg, Gg, Gg, Gg, Gg, Gg, Gg, XUrb, XUrb, Xoc, Xoc, Iwr, Iwr, Iwr, Iwr, Iwr, Xoc, Xoc, XUrb, XUrb, XUrb, XUrb, XUrb, XUrb, XUrb, XUrb, Gd, XUrb, XUrb, XUrb, XUrb, Gd, Gd, Gll^Eff, Gll^Eff, Gs^Ftp, Gs^Ftp, Gs^Ftp, Gs^Ftp, Gs^Ftp, Gs^Eff, Gs^Eff, XUrb, XUrb, XUrb, XUrb, Gd^Fts, XUrb, XUrb, XUrb, XUrb, Xoc, Xoc, Xoc, XUrb, XUrb, XUrb, XUrb, XUrb, XUrb, Xoc, Xoc, Iwr, Iwr, Iwr, Xoc, Xoc, XUrb, XUrb, XUrb
Gg, Gg, Gg, Gg, Gg, Gg, Gg, Gg, Gg, Gg, Gg, Gg, XUrb, XUrb, Xoc, Xoc, Iwr, Iwr, Iwr, Iwr, Iwr, Iwr, Iwr, Iwr, Iwr, Xoc, Xoc, XUrb, XUrb, XUrb, XUrb, XUrb, XUrb, XUrb, XUrb, XUrb, Gd, Gd, Xoc, Xoc, Xoc, Gll^Eff, Gll^Eff, Gs^Ftp, Gs^Ftp, Gs^Ftp, Gs^Ftp, Gs^Ftp, Gll^Eff, Gll^Eff, XUrb, XUrb, XUrb, XUrb, XUrb, XUrb, Xoc, Rr^Pw/, Iwr, Iwr, Iwr, Xoc, Xoc, XUrb, XUrb, XUrb, XUrb, XUrb, XUrb, Xoc, Xoc, Xoc, XUrb, XUrb, XUrb, XUrb, XUrb
Gg, Gg, Gg, Gg, Gg, Gg, Gg, Gg, Gg, Gg, Gg, XUrb, Xoc, Xoc, Iwr, Iwr, Iwr, Iwr, Iwr, Iwr, Iwr, Iwr, Iwr, Iwr, Xoc, Xoc, Gd^Ftp, Gd^Ftp, XUrb, XUrb, XUrb, XUrb, XUrb, XUrb, Gd^Ftp, XUrb, Rr^Pw/o, Xoc, Iwr, Iwr, Iwr, Xoc, Xoc, Gll^Eff, Gll^Eff, Gs^Ftp, Gll^Eff, Gll^Eff, XUrb, XUrb, XUrb, XUrb, XUrb, XUrb, Xoc, Xoc, Iwr, Iwr, Iwr, Iwr, Iwr, Iwr, Iwr, Xoc, Xoc, XUrb, XUrb, XUrb, XUrb, XUrb, XUrb, XUrb, XUrb, XUrb, XUrb, XUrb, XUrb
Gg, Gg, Gg, Gg, Gg, Gg, Gg, Gg, Gg, Gg, Gg, Xoc, Xoc, Iwr, Iwr, Iwr, Iwr, Iwr, Iwr, Iwr, Iwr, Iwr, Rr^Pw/, Xoc, Gd^Ftp, Gd^Ftp, XUrb, XUrb, XUrb, XUrb, XUrb, XUrb, Gd^Ftp, Gd^Ftp, Xoc, Xoc, Iwr, Iwr, Iwr, Iwr, Iwr, Iwr, Iwr, Xoc, Xoc, Gll^Eff, XUrb, XUrb, XUrb, XUrb, XUrb, XUrb, XUrb, Gd^Ftp, Gd^Ftp, Xoc, Xoc, Iwr, Iwr, Iwr, Xoc, Iwr, Iwr, Iwr, Xoc, Xoc, Gd^Ftp, XUrb, XUrb, XUrb, XUrb, XUrb, XUrb, XUrb, XUrb, XUrb, XUrb
Gg, Gg, Gg, Gg, Gg, Gg, Gg, Gg, Gg, Gg, Gg, Gg, Xoc, Xoc, Rr^Pw\, Iwr, Iwr, Iwr, Iwr, Iwr, Xoc, Xoc, Gd^Ftp, XUrb, XUrb, XUrb, XUrb, XUrb, XUrb, XUrb, Gd^Ftp, Gd^Ftp, Xoc, Xoc, Iwr, Iwr, Iwr, Iwr, Iwr, Iwr, Iwr, Iwr, Xoc, Xoc, XUrb, XUrb, XUrb, XUrb, XUrb, XUrb, XUrb, XUrb, XUrb, XUrb, XUrb, Gd^Ftp, Gd^Ftp, Xoc, Xoc, Xoc, Iwr, Rr^Pw\, Xoc, Xoc, Gd^Ftp, Gd^Ftp, XUrb, XUrb, XUrb, XUrb, XUrb, XUrb, XUrb, XUrb, XUrb, XUrb, XUrb
Gg, Gg, Gg, Gg, Gg, Gg, Gg, Gg, Gg, Gg, Gg, Gg, Xoc, XUrb, XUrb, Xoc, Xoc, Iwr, Xoc, Xoc, Gd^Ftp, Gd^Ftp, XUrb, XUrb, XUrb, XUrb, XUrb, XUrb, Gd^Ftp, XUrb, Rr^Pw/o, Xoc, Iwr, Iwr, Iwr, Iwr, Iwr, Iwr, Iwr, Iwr, Xoc, Xoc, XUrb, XUrb, XUrb, XUrb, XUrb, XUrb, Xoc, Dd^Ftd, Dd^Ftd, XUrb, XUrb, XUrb, XUrb, XUrb, XUrb, Gd^Ftp, Xoc, Iwr, Iwr, Iwr, Xoc, Gd^Ftp, XUrb, XUrb, XUrb, XUrb, Gd^Ftp, Gd^Ftp, Xoc, XUrb, XUrb, XUrb, XUrb, XUrb, XUrb
Gg, Gg, Gg, Gg, Gg, Gg, Gg, Gg, Gg, Gg, Gg, Gg, Gg, Xoc, Xoc, XUrb, XUrb, Xoc, Gd^Ftp, Gd^Ftp, XUrb, XUrb, XUrb, XUrb, XUrb, XUrb, XUrb, Gd^Ftp, Xoc, Xoc, Iwr, Iwr, Iwr, Iwr, Iwr, Iwr, Iwr, Iwr, Rr^Pw/, Xoc, XUrb, Xoc, Rr^Pr\o, XUrb, XUrb, XUrb, Xoc, Xoc, Iwr, Xoc, Xoc, Dd^Ftd, Dd^Ftd, XUrb, XUrb, XUrb, XUrb, XUrb, XUrb, Xoc, Xoc, Xoc, XUrb, XUrb, XUrb, XUrb, Gd^Ftp, Gd^Ftp, Xoc, Xoc, Iwr, Xoc, Xoc, XUrb, XUrb, XUrb, XUrb
Gg, Gg, Gg, Gg, Gg, Gg, Gg, Gg, Gg, Gg, Gg, Gg, Gg, Gg, Gg, Xoc, Xoc, XUrb, XUrb, XUrb, XUrb, XUrb, XUrb, XUrb, Gd^Ftp, XUrb, Rr^Pw/, Xoc, Xoc, Iwr, Iwr, Iwr, Iwr, Iwr, Iwr, Iwr, Xoc, Xoc, XUrb, XUrb, XUrb, XUrb, XUrb, Xoc, Xoc, Xoc, Iwr, Iwr, Iwr, Iwr, Iwr, Xoc, Xoc, Dd^Ftd, XUrb, XUrb, XUrb, XUrb, XUrb, XUrb, XUrb, XUrb, XUrb, XUrb, Gd^Ftp, Gd^Ftp, Xoc, Xoc, Iwr, Iwr, Iwr, Iwr, Iwr, Xoc, Xoc, XUrb, XUrb
Gg, Gg, Gg, Gg, Gg, Gg, Gg, Gg, Gg, Gg, Gg, Gg, Gg, Gg, Gg, Gg, Gg, Xoc, XUrb, XUrb, XUrb, XUrb, XUrb, XUrb, XUrb, Xoc, XUrb, XUrb, XUrb, Xoc, Xoc, Iwr, Iwr, Iwr, Xoc, Xoc, XUrb, Xoc, Rr^Pr\o, XUrb, XUrb, XUrb, Rr^Pw/, Xoc, Iwr, Xoc, Rr^Pw\, Iwr, Iwr, Iwr, Iwr, Iwr, Xoc, XUrb, XUrb, XUrb, XUrb, XUrb, XUrb, XUrb, XUrb, XUrb, Gd^Ftp, Gd^Ftp, Xoc, Xoc, Iwr, Xoc, Xoc, Iwr, Iwr, Iwr, Iwr, Iwr, Iwr, Xoc, XUrb
Gg, Gg, Gg, Gg, Gg, Gg, Gg, Gg, Gg, Gg, Gg, Gg, Gg, Gg, Gg, Gg, Gg, Gg, Gg, XUrb, XUrb, XUrb, XUrb, XUrb, Xoc, Xoc, Xoc, XUrb, XUrb, XUrb, XUrb, Xoc, Xoc, Xoc, XUrb, XUrb, XUrb, XUrb, XUrb, Xoc, Xoc, Xoc, Iwr, Iwr, Iwr, Iwr, Iwr, Xoc, Xoc, Iwr, Xoc, Xoc, XUrb, XUrb, XUrb, XUrb, XUrb, XUrb, XUrb, XUrb, XUrb, Gd^Ftp, Xoc, Xoc, Iwr, Iwr, Iwr, Iwr, Iwr, Rr^Pw\, Xoc, Iwr, Iwr, Iwr, Xoc, Xoc, XUrb
Gg, Gg, Gg, Gg, Gg, Gg, Gg, Gg, Gg, Gg, Gg, Gg, Gg, Gg, Gg, Gg, Gg, Gg, Gg, Gg, Gg, Xoc, Xoc, Xoc, XUrb, XUrb, XUrb, Xoc, Xoc, XUrb, Xoc, Xoc, XUrb, XUrb, XUrb, XUrb, XUrb, XUrb, Xoc, Xoc, Iwr, Xoc, Rr^Pw\, Iwr, Iwr, Iwr, Iwr, Iwr, Xoc, Xoc, XUrb, XUrb, XUrb, XUrb, XUrb, XUrb, XUrb, XUrb, Gd^Ftp, Gd^Ftp, Xoc, Rr^Pw/, Iwr, Iwr, Iwr, Iwr, Iwr, Iwr, Iwr, Iwr, Iwr, Xoc, Xoc, Xoc, XUrb, XUrb, XUrb
Gg, Gg, Gg, Gg, Gg, Gg, Gg, Gg, Gg, Gg, Gg, Gg, Gg, Gg, Gg, Gg, Gg, Gg, Gg, Gg, Gg, Gg, Gg, XUrb, XUrb, XUrb, XUrb, XUrb, XUrb, Xoc, XUrb, XUrb, XUrb, XUrb, XUrb, XUrb, Xoc, Xoc, Iwr, Iwr, Iwr, Iwr, Iwr, Xoc, Xoc, Iwr, Xoc, Xoc, XUrb, XUrb, XUrb, XUrb, XUrb, XUrb, XUrb, XUrb, Gd^Ftp, Gd^Ftp, Xoc, Xoc, Iwr, Iwr, Iwr, Iwr, Iwr, Iwr, Iwr, Iwr, Iwr, Iwr, Xoc, Xoc, XUrb, XUrb, XUrb, XUrb, XUrb
Gg, Gg, Gg, Gg, Gg, Gg, Gg, Gg, Gg, Gg, Gg, Gg, Gg, Gg, Gg, Gg, Gg, Gg, Gg, Gg, Gg, Gg, Gg, Gg, Gg, XUrb, XUrb, XUrb, XUrb, XUrb, XUrb, XUrb, XUrb, XUrb, XUrb, XUrb, Gg, Xoc, Xoc, Iwr, Iwr, Iwr, Iwr, Iwr, Xoc, Xoc, XUrb, XUrb, XUrb, XUrb, XUrb, XUrb, XUrb, XUrb, XUrb, XUrb, XUrb, Xoc, Xoc, Iwr, Iwr, Iwr, Iwr, Iwr, Iwr, Iwr, Iwr, Iwr, Xoc, Xoc, XUrb, XUrb, XUrb, XUrb, XUrb, XUrb, XUrb
