Gg, Gg, Gg, Gg, Gg, Gg, Gg, Gg, Gg, Gg, Gg, Gg, Gg, Gg, Gg, Gg, Gg, Gg, Gg, Gg, Gg, Gg, Gg, Gg, Gg, Gg, Gg, Gg, Gg, Gg, Gg, Gg, Gg, Gg, Gg, Gg, Gg, Gg, Gg, Gg, Gg, Gg, Gg, Gg, Gg, Gg, Gg, Gg, Gg, Gg, Gg, Gg, Gg, Gg, Gg, Gg, Gg, Gg, Gg, Gg, Gg, Gg, Gg, Gg, Gg, Gg, Gg, Gg, Gg, Gg, Gg, Gg, Gg, Gg, Gg, Gg, Gg
Gg, Gg, Gg, Gg, Gg, Gg, Gg, Gg, Gg, Gg, Gg, Gg, Gg, Gg, Gg, Gg, Gg, Gg, Gg, Gg, Gg, Gg, Gg, Gg, Gg, Gg, Gg, Gg, Gg, Gg, Gg, Gg, Gg, Gg, Gg, Gg, Gg, Gg, Gg, Gg, Gg, Gg, Gg, Gg, Gg, Gg, Gg, Gg, Gg, Gg, Gg, Gg, Gg, Gg, Gg, Gg, Gg, Gg, Gg, Gg, Gg, Gg, Gg, Gg, Gg, Gg, Gg, Gg, Gg, Gg, Gg, Gg, Gg, Gg, Gg, Gg, Gg
Gg, Gg, Gg, Gg, Gg, Gg, Gg, Gg, Gg, Gg, Gg, Gg, Gg, Gg, Gg, Gg, Gg, Gg, Gg, Gg, Gg, Gg, Gg, Gg, Gg, Gg, Gg, Gg, Gg, Gg, Gg, Gg, Gg, Gg, Gg, Gg, Gg, Gg, Gg, Gg, Gg, Gg, Gg, Gg, Gg, Gg, Gg, Gg, Gg, Gg, Gg, Gg, Gg, Gg, Gg, Gg, Gg, Gg, Gg, Gg, Gg, Gg, Gg, Gg, Gg, Gg, Gg, Gg, Gg, Gg, Gg, Gg, Gg, Gg, Gg, Gg, Gg
Gg, Gg, Gg, Gg, Gg, Gg, Gg, Gg, Gg, Gg, Gg, Gg, Gg, Gg, Gg, Gg, Gg, Gg, Gg, Gg, Gg, Gg, Gg, Gg, Gg, Gg, Gg, Gg, Gg, Gg, Gg, Gg, Gg, Gg, Gg, Gg, Gg, Gg, Gg, Gg, Gg, Gg, Gg, Gg, Gg, Gg, Gg, Gg, Gg, Gg, Gg, Gg, Gg, Gg, Gg, Gg, Gg, Gg, Gg, Gg, Gg, Gg, Gg, Gg, Gg, Gg, Gg, Gg, Gg, Gg, Gg, Gg, Gg, Gg, Gg, Gg, Gg
Gg, Gg, Gg, Gg, Gg, Gg, Gg, Gg, Gg, Gg, Gg, Gg, Gg, Gg, Gg, Gg, Gg, Gg, Gg, Gg, Gg, Gg, Gg, Gg, Gg, Gg, Gg, Gg, Gg, Gg, Gg, Gg, Gg, Gg, Gg, Gg, Gg, Gg, Gg, Gg, Gg, Gg, Gg, Gg, Gg, Gg, Gg, Gg, Gg, Gg, Gg, Gg, Gg, Gg, Gg, Gg, Gg, Gg, Gg, Gg, Gg, Gg, Gg, Gg, Gg, Gg, Gg, Gg, Gg, Gg, Gg, Gg, Gg, Gg, Gg, Gg, Gg
Gg, Gg, Gg, Gg, Gg, Gg, Gg, Gg, Gg, Gg, Gg, Gg, Gg, Gg, Gg, Gg, Gg, Gg, Gg, Gg, Gg, Gg, Gg, Gg, Gg, Gg, Gg, Gg, Gg, Gg, Gg, Gg, Gg, Gg, Gg, Gg, Gg, Gg, Gg, Gg, Gg, Gg, Gg, Gg, Gg, Gg, Gg, Gg, Gg, Gg, Gg, Gg, Gg, Gg, Gg, Gg, Gg, Gg, Gg, Gg, Gg, Gg, Gg, Gg, Gg, Gg, Gg, Gg, Gg, Gg, Gg, Gg, Gg, Gg, Gg, Gg, Gg
Gg, Gg, Gg, Gg, Gg, Gg, Gg, Gg, Gg, Gg, Gg, Gg, Gg, Gg, Gg, Gg, Gg, Gg, Gg, Gg, Gg, Gg, Gg, Gg, Gg, Gg, Gg, Gg, Gg, Gg, Gg, Gg, Gg, Gg, Gg, Gg, Gg, Gg, Gg, Gg, Gg, Gg, Gg, Gg, Gg, Gg, Gg, Gg, Gg, Gg, Gg, Gg, Gg, Gg, Gg, Gg, Gg, Gg, Gg, Gg, Gg, Gg, Gg, Gg, Gg, Gg, Gg, Gg, Gg, Gg, Gg, Gg, Gg, Gg, Gg, Gg, Gg
Gg, Gg, Gg, Gg, Gg, Gg, Gg, Gg, Gg, Gg, Gg, Gg, Gg, Gg, Gg, Gg, Gg, Gg, Gg, Gg, Gg, Gg, Gg, Gg, Gg, Gg, Gg, Gg, Gg, Gg, Gg, Gg, Gg, Gg, Gg, Gg, Gg, Gg, Gg, Gg, Gg, Gg, Gg, Gg, Gg, Gg, Gg, Gg, Gg, Gg, Gg, Gg, Gg, Gg, Gg, Gg, Gg, Gg, Gg, Gg, Gg, Gg, Gg, Gg, Gg, Gg, Gg, Gg, Gg, Gg, Gg, Gg, Gg, Gg, Gg, Gg, Gg
Gg, Gg, Gg, Gg, Gg, Gg, Gg, Gg, Gg, Gg, Gg, Gg, Gg, Gg, Gg, Gg, Gg, Gg, Gg, Gg, Gg, Gg, Gg, Gg, Gg, Gg, Gg, Gg, Gg, Gg, Gg, Gg, Gg, Gg, Gg, Gg, Gg, Gg, Gg, Gg, Gg, Gg, Gg, Gg, Gg, Gg, Gg, Gg, Gg, Gg, Gg, Gg, XUrb, Gg, Gg, Gg, Gg, Gg, Gg, Gg, Gg, Gg, Gg, Gg, Gg, Gg, Gg, Gg, Gg, Gg, Gg, Gg, Gg, Gg, Gg, Gg, Gg
Gg, Gg, Gg, Gg, Gg, Gg, Gg, Gg, Gg, Gg, Gg, Gg, Gg, Gg, Gg, Gg, Gg, Gg, Gg, Gg, Gg, Gg, Gg, Gg, Gg, Gg, Gg, Gg, Gg, Gg, Gg, Gg, Gg, Gg, Gg, Gg, Gg, Gg, Gg, Gg, Gg, Gg, Gg, Gg, Gg, Gg, Gg, Gg, Gg, Gg, XUrb, XUrb, XUrb, XUrb, XUrb, Gg, Gg, Gg, Gg, Gg, Gg, Gg, Gg, Gg, Gg, Gg, Gg, Gg, Gg, Gg, Gg, Gg, Gg, Gg, Gg, Gg, Gg
Gg, Gg, Gg, Gg, Gg, Gg, Gg, Gg, Gg, Gg, Gg, Gg, Gg, Gg, Gg, Gg, Gg, Gg, Gg, Gg, Gg, Gg, Gg, Gg, Gg, Gg, Gg, Gg, Gg, Gg, Gg, Gg, Gg, Gg, Gg, Gg, Gg, Gg, Gg, Gg, Gg, Gg, Gg, Gg, Gg, Gg, Gg, Gg, XUrb, XUrb, XUrb, XUrb, Xoc, XUrb, XUrb, XUrb, XUrb, Gg, Gg, Gg, Gg, Gg, Gg, Gg, Gg, Gg, Gg, Gg, Gg, Gg, Gg, Gg, Gg, Gg, Gg, Gg, Gg
Gg, Gg, Gg, Gg, Gg, Gg, Gg, Gg, Gg, Gg, Gg, Gg, Gg, Gg, Gg, Gg, Gg, Gg, Gg, Gg, Gg, Gg, Gg, Gg, Gg, Gg, Gg, Gg, Gg, Gg, Gg, Gg, Gg, Gg, Gg, Gg, Gg, Gg, Gg, Gg, Gg, Gg, Gg, Gg, Gg, Gg, XUrb, XUrb, XUrb, XUrb, Xoc, Xoc, Iwr^Eby, Xoc, Xoc, XUrb, XUrb, XUrb, XUrb, Gg, Gg, Gg, Gg, Gg, Gg, Gg, Gg, Gg, Gg, Gg, Gg, Gg, Gg, Gg, Gg, Gg, Gg
Gg, Gg, Gg, Gg, Gg, Gg, Gg, Gg, Gg, Gg, Gg, Gg, Gg, Gg, Gg, Gg, Gg, Gg, Gg, Gg, Gg, Gg, Gg, Gg, Gg, Gg, Gg, Gg, Gg, Gg, Gg, Gg, Gg, Gg, Gg, Gg, Gg, Gg, Gg, Gg, Gg, Gg, Gg, Gg, XUrb, XUrb, XUrb, XUrb, Xoc^Efs, Xoc, Iwr^Ewz, Xoc, Rr^Pw\, Iwr^Eqy, Iwr, Xoc, Xoc, XUrb, XUrb, Gg, Gg, Gg, Gg, Gg, Gg, Gg, Gg, Gg, Gg, Gg, Gg, Gg, Gg, Gg, Gg, Gg, Gg
Gg, Gg, Gg, Gg, Gg, Gg, Gg, Gg, Gg, Gg, Gg, Gg, Gg, Gg, Gg, Gg, Gg, Gg, Gg, Gg, Gg, Gg, Gg, Gg, Gg, Gg, Gg, Gg, Gg, Gg, XUrb, XUrb, XUrb, Gg, Gg, Gg, Gg, Gg, Gg, Gg, Gg, Gg, XUrb, XUrb, XUrb, XUrb, Rr^Pw/o, Xoc, Iwr, Iwr^Ewz, Iwr^Egz, Iwr, Iwr^Ekz, Xoc, Iwr, Iwr^Eay, Xoc, XUrb, XUrb, Gg, Gg, Gg, Gg, Gg, Gg, Gg, Gg, Gg, Gg, Gg, Gg, Gg, Gg, Gg, Gg, Gg, Gg
Gg, Gg, Gg, Gg, Gg, Gg, Gg, Gg, Gg, Gg, Gg, Gg, Gg, Gg, Gg, Gg, Gg, Gg, Gg, Gg, Gg, Gg, Gg, Gg, Gg, Gg, Gg, Gg, XUrb, XUrb, XUrb, XUrb, XUrb, XUrb, XUrb, Gg, Gg, Gg, Gg, Gg, XUrb, XUrb, XUrb, XUrb, Xoc^Efs, Xoc^Efs, Iwr, Iwr, Iwr, Iwr, Iwr, Iwr^Egz, Iwr^Egz, Xoc, Xoc^Efs, Iwr^Eby, Xoc, XUrb, XUrb, Gg, Gg, Gg, Gg, Gg, Gg, Gg, Gg, Gg, Gg, Gg, Gg, Gg, Gg, Gg, Gg, Gg, Gg
Gg, Gg, Gg, Gg, Gg, Gg, Gg, Gg, Gg, Gg, Gg, Gg, Gg, Gg, Gg, Gg, Gg, Gg, Gg, Gg, Gg, Gg, Gg, Gg, Gg, Gg, XUrb, XUrb, XUrb, XUrb, Xoc, Gd^Fts, Gd^Fts, XUrb, XUrb, XUrb, XUrb, Gg, XUrb, XUrb, XUrb, XUrb, Xoc, Xoc, Iwr, Iwr, Iwr^Ebz, Iwr, Iwr, Iwr, Iwr, Iwr, Xoc, Xoc^Efs, Iwr^Egz, Xoc, Xoc, XUrb, XUrb, XUrb, XUrb, Gg, Gg, Gg, Gg, Gg, Gg, Gg, Gg, Gg, Gg, Gg, Gg, Gg, Gg, Gg, Gg
Gg, Gg, Gg, Gg, Gg, Gg, Gg, Gg, Gg, Gg, Gg, Gg, Gg, Gg, Gg, Gg, Gg, Gg, Gg, Gg, Gg, Gg, Gg, Gg, XUrb, XUrb, XUrb, XUrb, Xoc, Xoc, Iwr, Xoc, Xoc, Xoc, Xoc, XUrb, XUrb, XUrb, XUrb, XUrb, XUrb, XUrb, Xoc, Iwr, Iwr^Ebz, Iwr^Ebz, Iwr, Iwr, Iwr^Ebz, Iwr, Iwr, Iwr, Iwr^Eaz, Iwr, Iwr, Iwr^Ekz, Iwr, Rr^Pw\o, Xoc^Efs, XUrb, XUrb, XUrb, Gg, Gg, Gg, Gg, Gg, Gg, Gg, Gg, Gg, Gg, Gg, Gg, Gg, Gg, Gg
Gg, Gg, Gg, Gg, Gg, Gg, Gg, Gg, Gg, Gg, Gg, Gg, Gg, Gg, Gg, Gg, Gg, Gg, Gg, Gg, Gg, Gg, XUrb, XUrb, XUrb, XUrb, Xoc, Xoc, Iwr, Iwr, Iwr, Iwr, Iwr, Xoc, Iwr, Rr^Pw\, Xoc, XUrb, XUrb, XUrb, XUrb, Dd^Ftd, Dd^Ftd, Xoc, Xoc, Iwr, Iwr^Ebz, Iwr^Ebz, Xoc^Efs, Iwr, Iwr^Eaz, Iwr, Iwr, Iwr, Iwr^Eaz, Iwr, Iwr, Iwr, Iwr^Egz, Xoc, XUrb, XUrb, Gg, Gg, Gg, Gg, Xoc, Gg, Gg, Gg, Gg, Gg, Gg, Gg, Gg, Gg, Gg
Gg, Gg, Gg, Gg, Gg, Gg, Gg, Gg, Gg, Gg, Gg, Gg, Gg, Gg, Gg, Gg, Gg, Gg, Gg, Gg, Gg, XUrb, XUrb, XUrb, Xoc, Xoc, Iwr, Iwr, Iwr, Iwr, Iwr, Iwr, Iwr, Iwr, Iwr, Xoc, Xoc, Xoc, Gd^Fts, XUrb, XUrb, XUrb, XUrb, Dd^Ftd, Dd^Ftd, Xoc, Xoc, Xoc^Efs, Iwr^Ebz, Iwr^Ejz, Iwr, Iwr, Iwr^Eaz, Iwr, Iwr, Iwr, Iwr^Ekz, Iwr, Xoc, Xoc, XUrb, XUrb, Gg, Gg, Xoc, Xoc, Iwr, Xoc, Xoc, Gg, Gg, Gg, Gg, Gg, Gg, Gg, Gg
Gg, Gg, Gg, Gg, Gg, Gg, Gg, Gg, Gg, Gg, Gg, Gg, Gg, Gg, Gg, Gg, Gg, Gg, Gg, Gg, Gg, XUrb, XUrb, XUrb, XUrb, Xoc, Xoc, Iwr, Iwr, Iwr, Iwr, Iwr, Iwr, Iwr, Iwr, Iwr, Iwr, Xoc, Xoc, Gd^Fts, Gd^Fts, XUrb, XUrb, XUrb, XUrb, Dd^Ftd, Xoc^Efs, Iwr^Ejz, Iwr, Iwr, Iwr^Ebz, Iwr^Ekz, Iwr, Iwr, Iwr, Iwr^Ebz, Xoc^Efs, Xoc, XUrb, XUrb, XUrb, XUrb, Xoc, Rr^Pw/, Iwr, Iwr, Iwr, Iwr, Iwr, Xoc, Xoc, Gg, Gg, Gg, Xoc, Gg, Gg
Gg, Gg, Gg, Gg, Gg, Gg, Gg, Gg, Gg, Gg, Gg, Gg, Gg, Gg, Gg, Gg, Gg, Gg, Gg, Gg, Gg, Gg, XUrb, XUrb, XUrb, XUrb, XUrb, Xoc, Xoc, Iwr, Iwr, Iwr, Iwr, Iwr, Iwr, Iwr, Iwr, Iwr, Xoc, Xoc, Gd^Ftp, Gd^Ftp, XUrb, XUrb, XUrb, XUrb^Efs, XUrb^Efs, Xoc^Efs, Xoc^Efs, Iwr, Iwr, Iwr, Iwr^Ebz, Iwr^Ekz, Xoc^Efs, Xoc^Efs, XUrb, XUrb, XUrb, XUrb, Xoc, Xoc, Iwr, Iwr, Iwr, Iwr, Iwr, Iwr, Iwr, Iwr, Iwr, Xoc, Xoc, Xoc, Iwr, Xoc, Xoc
Gg, Gg, Gg, Gg, Gg, Gg, Gg, Gg, Gg, Gg, Gg, Gg, Gg, Gg, Gg, Gg, Gg, Gg, Gg, Gg, XUrb, XUrb, XUrb, XUrb, Xoc, XUrb, XUrb, XUrb, XUrb, Xoc, Xoc, Iwr, Iwr, Iwr, Iwr, Iwr, Xoc, Xoc, Gd^Ftp, Gd^Ftp, XUrb, XUrb, XUrb, XUrb, XUrb, XUrb, XUrb, XUrb^Efs, XUrb, Rr^Pw\o, Xoc^Efs, Iwr, Xoc, Xoc, XUrb, XUrb, XUrb, XUrb, XUrb, XUrb, XUrb, Xoc, Xoc, Iwr, Iwr, Iwr, Iwr, Iwr, Iwr, Iwr, Iwr, Iwr, Iwr, Iwr, Iwr, Iwr, Xoc
Gg, Gg, Gg, Gg, Gg, Gg, Gg, Gg, Gg, Gg, Gg, Gg, Gg, Gg, Gg, Gg, Gg, Gg, XUrb, XUrb, XUrb, XUrb, Xoc, Xoc, Iwr, Xoc, Xoc, XUrb, XUrb, XUrb, XUrb, Xoc, Xoc, Iwr, Xoc, Xoc, Gd^Ftp, Gd^Ftp, XUrb, XUrb, XUrb, XUrb, XUrb, XUrb, Gll^Eff, Gll^Eff, Gll^Eff, XUrb, XUrb, XUrb^Efs, XUrb^Efs, Xoc^Efs, XUrb, XUrb, XUrb, XUrb, XUrb, XUrb, Xoc, XUrb, XUrb, XUrb, XUrb, Xoc, Xoc, Iwr, Iwr, Iwr, Iwr, Iwr, Iwr, Iwr, Iwr, Iwr, Xoc, Xoc, XUrb
Gg, Gg, Gg, Gg, Gg, Gg, Gg, Gg, Gg, Gg, Gg, Gg, Gg, Gg, Gg, Gg, XUrb, XUrb, XUrb, XUrb, Xoc, Xoc, Iwr, Iwr, Iwr, Iwr, Iwr, Xoc, Xoc, XUrb, XUrb, XUrb, XUrb, Xoc, Gd^Ftp, Gd^Ftp, XUrb, XUrb, XUrb, XUrb, XUrb, XUrb, Gll^Eff, Gll^Eff, Gs^Ftp, Gs^Ftp, Gs^Ftp, Gll^Eff, Gll^Eff, XUrb, XUrb, XUrb, XUrb, XUrb, XUrb, XUrb, Rr^Pw/, Xoc, Iwr, Xoc, Xoc, XUrb, XUrb, XUrb, XUrb, Xoc, Xoc, Iwr, Iwr, Iwr, Iwr, Iwr, Xoc, Xoc, XUrb, XUrb, XUrb
Gg, Gg, Gg, Gg, Gg, Gg, Gg, Gg, Gg, Gg, Gg, Gg, Gg, Gg, XUrb, XUrb, XUrb, XUrb, Xoc, Xoc, Iwr, Iwr, Iwr, Iwr, Iwr, Iwr, Iwr, Iwr, Iwr, Xoc, Xoc, XUrb, XUrb, XUrb, XUrb, XUrb, XUrb, XUrb, XUrb, XUrb, Gll^Eff, Gll^Eff, Gs^Ftp, Gs^Ftp, Gs^Ftp, Gs^Ftp, Gs^Ftp, Gs^Ftp, Gs^Ftp, Gll^Eff, Gd^Eff, XUrb, XUrb, XUrb, Xoc, Xoc, Iwr, Iwr, Iwr, Iwr, Iwr, Xoc, Xoc, XUrb, XUrb, XUrb, XUrb, Xoc, Xoc, Iwr, Xoc, Xoc, XUrb, XUrb, XUrb, XUrb, Gg
Gg, Gg, Gg, Gg, Gg, Gg, Gg, Gg, Gg, Gg, Gg, Gg, XUrb, XUrb, XUrb, XUrb, Xoc, Xoc, Iwr, Iwr, Iwr, Iwr, Iwr, Iwr, Iwr, Iwr, Iwr, Iwr, Xoc, Xoc, Gd^Ftp, Gd^Ftp, XUrb, XUrb, XUrb, XUrb, XUrb, XUrb, Xoc, Xoc, Xoc, Gll^Eff, Gll^Eff, Gs^Ftp, Gs^Ftp, Gs^Ftp, Gs^Ftp, Gs^Ftp, Gll^Eff, Gll^Eff, XUrb, XUrb, XUrb, Xoc, Xoc, Iwr, Iwr, Iwr, Iwr, Iwr, Iwr, Iwr, Iwr, Xoc, Xoc, XUrb, XUrb, XUrb, XUrb, Xoc, XUrb, XUrb, XUrb, XUrb, Gg, Gg, Gg
Gg, Gg, Gg, Gg, Gg, Gg, Gg, Gg, Gg, Gg, Gg, XUrb, XUrb, XUrb, XUrb, Xoc, Xoc, Iwr, Iwr, Iwr, Iwr, Iwr, Iwr, Iwr, Iwr, Iwr, Rr^Pw/, Xoc, Gd^Ftp, Gd^Ftp, XUrb, XUrb, XUrb, XUrb, XUrb, XUrb, Rr^Pw/o, Xoc, Iwr, Iwr, Iwr, Xoc, Xoc, Gll^Eff, Gll^Eff, Gs^Ftp, Gll^Eff, Gll^Eff, XUrb, XUrb, XUrb, XUrb, XUrb, XUrb, XUrb, Xoc, Xoc, Iwr, Iwr, Iwr, Iwr, Iwr, Xoc, Xoc, XUrb, XUrb, XUrb, XUrb, XUrb, XUrb, XUrb, XUrb, Gg, Gg, Gg, Gg, Gg
Gg, Gg, Gg, Gg, Gg, Gg, Gg, Gg, Gg, Gg, Gg, Gg, Gg, XUrb, XUrb, XUrb, XUrb, Xoc, Xoc, Iwr, Iwr, Iwr, Iwr, Iwr, Xoc, Xoc, Gd^Ftp, XUrb, XUrb, XUrb, XUrb, XUrb, XUrb, XUrb, Xoc, Xoc, Iwr, Iwr, Iwr, Iwr, Iwr, Iwr, Iwr, Xoc, Xoc, Gll^Eff, XUrb, XUrb, XUrb, XUrb, XUrb, XUrb, Gg, XUrb, XUrb, XUrb, XUrb, Xoc, Xoc, Iwr, Xoc, Xoc, XUrb, XUrb, XUrb, XUrb, Gg, Gg, Gg, XUrb, Gg, Gg, Gg, Gg, Gg, Gg, Gg
Gg, Gg, Gg, Gg, Gg, Gg, Gg, Gg, Gg, Gg, Gg, Gg, Gg, Gg, Gg, XUrb, XUrb, XUrb, XUrb, Xoc, Xoc, Iwr, Xoc, Xoc, Gd^Ftp, Gd^Ftp, XUrb, XUrb, XUrb, XUrb, XUrb, XUrb, Xoc, Xoc, Iwr, Iwr, Iwr, Iwr, Iwr, Iwr, Iwr, Iwr, Xoc, Xoc, XUrb, XUrb, XUrb, XUrb, XUrb, XUrb, Gg, Gg, Gg, Gg, Gg, XUrb, XUrb, XUrb, XUrb, Xoc, XUrb, XUrb, XUrb, XUrb, Gg, Gg, Gg, Gg, Gg, Gg, Gg, Gg, Gg, Gg, Gg, Gg, Gg
Gg, Gg, Gg, Gg, Gg, Gg, Gg, Gg, Gg, Gg, Gg, Gg, Gg, Gg, Gg, Gg, Gg, XUrb, XUrb, XUrb, XUrb, Xoc, Gd^Ftp, Gd^Ftp, XUrb, XUrb, XUrb, XUrb, XUrb, XUrb, Rr^Pw/o, Xoc, Iwr, Iwr, Iwr, Iwr, Iwr, Iwr, Iwr, Iwr, Xoc, Xoc, XUrb, XUrb, XUrb, XUrb, XUrb, XUrb, Xoc, Dd^Ftd, Dd^Ftd, Gg, Gg, Gg, Gg, Gg, Gg, XUrb, XUrb, XUrb, XUrb, XUrb, Gg, Gg, Gg, Gg, Gg, Gg, Gg, Gg, Gg, Gg, Gg, Gg, Gg, Gg, Gg
Gg, Gg, Gg, Gg, Gg, Gg, Gg, Gg, Gg, Gg, Gg, Gg, Gg, Gg, Gg, Gg, Gg, Gg, Gg, XUrb, XUrb, XUrb, XUrb, XUrb, XUrb, XUrb, XUrb, XUrb, Xoc, Xoc, Iwr, Iwr, Iwr, Iwr, Iwr, Iwr, Iwr, Iwr, Rr^Pw/, Xoc, XUrb, Xoc, Rr^Pr\o, XUrb, XUrb, XUrb, Xoc, Xoc, Iwr, Xoc, Xoc, Dd^Ftd, Dd^Ftd, Gg, Gg, Gg, Gg, Gg, Gg, XUrb, Gg, Gg, Gg, Gg, Gg, Gg, Gg, Gg, Gg, Gg, Gg, Gg, Gg, Gg, Gg, Gg, Gg
Gg, Gg, Gg, Gg, Gg, Gg, Gg, Gg, Gg, Gg, Gg, Gg, Gg, Gg, Gg, Gg, Gg, Gg, Gg, Gg, Gg, XUrb, XUrb, XUrb, XUrb, XUrb, XUrb, Xoc, Xoc, Iwr, Iwr, Iwr, Iwr, Iwr, Iwr, Iwr, Xoc, Xoc, XUrb, XUrb, XUrb, XUrb, XUrb, Xoc, Xoc, Xoc, Iwr, Iwr, Iwr, Iwr, Iwr, Xoc, Xoc, Dd^Ftd, Gg, Gg, Gg, Gg, Gg, Gg, Gg, Gg, Gg, Gg, Gg, Gg, Gg, Gg, Gg, Gg, Gg, Gg, Gg, Gg, Gg, Gg, Gg
Gg, Gg, Gg, Gg, Gg, Gg, Gg, Gg, Gg, Gg, Gg, Gg, Gg, Gg, Gg, Gg, Gg, Gg, Gg, Gg, Gg, Gg, Gg, XUrb, XUrb, XUrb, XUrb, XUrb, XUrb, Xoc, Xoc, Iwr, Iwr, Iwr, Xoc, Xoc, XUrb, Xoc, Rr^Pr\o, XUrb, XUrb, XUrb, Rr^Pw/, Xoc, Iwr, Iwr, Iwr, Iwr, Iwr, Iwr, Iwr, Iwr, Xoc, Gg, Gg, Gg, Gg, Gg, Gg, Gg, Gg, Gg, Gg, Gg, Gg, Gg, Gg, Gg, Gg, Gg, Gg, Gg, Gg, Gg, Gg, Gg, Gg
Gg, Gg, Gg, Gg, Gg, Gg, Gg, Gg, Gg, Gg, Gg, Gg, Gg, Gg, Gg, Gg, Gg, Gg, Gg, Gg, Gg, Gg, Gg, Gg, Gg, XUrb, XUrb, XUrb, XUrb, XUrb, XUrb, Xoc, Xoc, Xoc, XUrb, XUrb, XUrb, XUrb, XUrb, Xoc, Xoc, Xoc, Iwr, Iwr, Iwr, Iwr, Iwr, Iwr, Iwr, Iwr, Xoc, Xoc, Gg, Gg, Gg, Gg, Gg, Gg, Gg, Gg, Gg, Gg, Gg, Gg, Gg, Gg, Gg, Gg, Gg, Gg, Gg, Gg, Gg, Gg, Gg, Gg, Gg
Gg, Gg, Gg, Gg, Gg, Gg, Gg, Gg, Gg, Gg, Gg, Gg, Gg, Gg, Gg, Gg, Gg, Gg, Gg, Gg, Gg, Gg, Gg, Gg, Gg, Gg, Gg, XUrb, XUrb, XUrb, XUrb, XUrb, XUrb, XUrb, XUrb, XUrb, XUrb, XUrb, Xoc, Xoc, Iwr, Iwr, Iwr, Iwr, Iwr, Iwr, Iwr, Iwr, Xoc, Xoc, Gg, Gg, Gg, Gg, Gg, Gg, Gg, Gg, Gg, Gg, Gg, Gg, Gg, Gg, Gg, Gg, Gg, Gg, Gg, Gg, Gg, Gg, Gg, Gg, Gg, Gg, Gg
Gg, Gg, Gg, Gg, Gg, Gg, Gg, Gg, Gg, Gg, Gg, Gg, Gg, Gg, Gg, Gg, Gg, Gg, Gg, Gg, Gg, Gg, Gg, Gg, Gg, Gg, Gg, Gg, Gg, XUrb, XUrb, XUrb, XUrb, XUrb, XUrb, XUrb, Xoc, Xoc, Iwr, Iwr, Iwr, Iwr, Iwr, Iwr, Iwr, Iwr, Xoc, Xoc, Gg, Gg, Gg, Gg, Gg, Gg, Gg, Gg, Gg, Gg, Gg, Gg, Gg, Gg, Gg, Gg, Gg, Gg, Gg, Gg, Gg, Gg, Gg, Gg, Gg, Gg, Gg, Gg, Gg
Gg, Gg, Gg, Gg, Gg, Gg, Gg, Gg, Gg, Gg, Gg, Gg, Gg, Gg, Gg, Gg, Gg, Gg, Gg, Gg, Gg, Gg, Gg, Gg, Gg, Gg, Gg, Gg, Gg, Gg, XUrb, XUrb, XUrb, XUrb, XUrb, XUrb, Gg, Xoc, Xoc, Iwr, Iwr, Iwr, Iwr, Iwr, Xoc, Xoc, Gg, Gg, Gg, Gg, Gg, Gg, Gg, Gg, Gg, Gg, Gg, Gg, Gg, Gg, Gg, Gg, Gg, Gg, Gg, Gg, Gg, Gg, Gg, Gg, Gg, Gg, Gg, Gg, Gg, Gg, Gg
