Mdd, Mdd, Hd, Hd, Hhd^Em, Mdd, Mdd, Mdd, Hd, Hd, Dd, Dd, Dd, Re, Re, Rd, Dd, Hd, Hd, Hd, Hd, Dd, Dd, Hd, Mdd, Mdd, Mdd, Mdd, Mdd, Mdd^Xm, Mdd^Xm, Mdd^Xm, Mdd^Xm, Mdd^Xm, Mdd^Xm, Mdd^Xm, Mdd, Mdd, Mdd, Mdd, Mdd, Mdd
Mdd, Hhd^Uf, Ds, Ds, Dd^Esd, Hd^Es, Hd, Hd^Uf, Re^Vct, Dd, Rd^Uf, Rd, Rd, Dd, Ds, Rd, Dd, Hd, Hd, Dd, Dd, Dd, Dd, Hd, Hd, Mdd, Mdd, Mdd, Mdd, Mdd, Mdd, Mdd, Mdd, Mdd^Xm, Mdd, Mdd, Mdd, Mdd, Mdd, Mdd, Mdd, Mdd
Hd, Dd^Vdt, Dd, Dd, Ds, Dd, Dd, Dd, Re, Rd, Rd, Re, Re, Dd, Dd, Re, Dd, Dd, Ds, Ds, Ds, Dd^Edp, Dd, Hd, Hd, Hhd^Fetd, Hhd^Es, Hhd^Uf, Hhd^Em, Mdd, Mdd, Mdd, Mdd, Mdd, Mdd, Mdd, Mdd, Mdd, Re, Re, Rd, Mdd
Hd, Dd, Dd^Edp, Dd^Esd, Ds, Ds, Dd, Rd, Re^Ecf, Rd, Rd, Cud, Rd, Re, Re, Re, Dd, Dd, Dd, Ds, Ds, Dd, Dd, Dd, Dd, Hd, Hd, Hhd, Hd, Hd^Do, Hd, Hhd^Em, Mdd, Mdd, Mdd, Mdd, Rd, Rd, Mdd, Mdd, Mdd, Rd
Hhd, Hd^Do, Dd, Dd, Dd^Esd, Dd, Rd^Vct, Rd^Edt, Re, Cud, Cud, 2 Kud, Cud, Cud, Re, Rd, Rd, Dd, Rd^Uf, Dd, Dd, Ds, Dd, Ds, Dd^Esd, Hd, Dd, Dd, Dd^Edpp, Hd, Hd^Uf, Hd, Hhd^Es, Mdd, Rd, Rd, Mdd, Hhd^Vhhr, Mdd, Mdd, Mdd^Xm, Mdd
Mdd, Hhd, Hd, Ds, Ds, Dd, Dd, Re, Rd, Rd, Re, Cud, Re, Re^Edt, Rd^Vct, Dd, Dd, Re, Rd, Rd, Re, Dd, Dd, Dd, Dd, Dd, Re, Dd, Rd, Hd, Hd, Hd, Rd, Rd, Hd, Mdd, Mdd, Mdd, Mdd, Mdd, Mdd^Xm, Mdd^Xm
Mdd, Hhd^Uf, Hd, Hd, Ds, Dd, Dd, Rd^Uf, Dd, Re, Rd, Re, Re, Rd, Ds, Dd, Dd, Dd, Ds, Ds, Dd^Edp, Re, Rd, Rd, Re, Rd, Dd, Re, Dd, Rd, Rd, Rd, Hd, Hd, Hd, Hhd^Uf, Hd^Uf, Mdd, Mdd, Mdd, Mdd, Mdd
Mdd, Mdd, Mdd, Hd^Es, Hhd^Em, Ds, Hhd^Uf, Dd, Dd, Dd, Dd, Rd, Dd, Rd, Dd, Ds, Dd, Dd^Esd, Dd, Dd, Dd, Rd, Rd, Dd, Dd^Esd, Dd, Dd, Dd, Dd, Dd^Edp, Dd, Dd, Dd^Esd, Dd, Dd, Ds, Ds, Ds, Mdd, Mdd, Mdd, Mdd
Mdd, Mdd, Mdd, Mdd, Mdd, Hhd, Hhd, Dd, Dd, Dd, Dd, Dd, Dd, Dd^Esd, Dd, Ds, Dd, Dd, Ds, Dd, Dd, Dd, Re, Dd, Hd, Hd, Mdd, Dd, Hd, Hd, Dd, Ds, Ds, Ds, Dd, Ds^Esd, Dd, Hd, Mdd, Mdd, Mdd, Mdd
Hhd, Mdd, Mdd, Mdd, Mdd, Mdd, Mdd, Hhd, Hhd^Do, Dd, Hd, Ds, Ds, Dd, Dd, Dd, Ds, Ds, Ds, Dd, Rd, Re, Dd, Dd, Hd, Mdd, Mdd, Dd^Esd, Mdd, Mdd, Hd, Dd, Dd, Dd, Ds, Dd, Hd, Hd, Hhd^Uf, Mdd, Rd, Rd^Esd
Hd, Hd^Em, Hd, Mdd, Hhd^Uf, Mdd, Mdd, Mdd, Mdd, Hd, Hd, Hd, Ds, Dd, Dd^Esd, Dd, Dd, Ds, Dd, Rd, Dd, Dd^Edpp, Dd, Dd, Dd, Hd^Do, Mdd, Hhd^Uf, Mdd, Mdd, Hd, Dd, Hd, Hd, Mdd, Mdd, Mdd, Mdd, Mdd, Mdd, Rd, Dd
Dd, Hd, Hd, Hd, Hd, Hhd^Em, Hd^Es, Mdd, Mdd, Hd^Uf, Hd, Hd^Es, Hd, Dd, Dd, Dd, Dd, Dd^Vdt, Rd, Dd, Dd^Esd, Dd, Hd, Hd, Mdd, Mdd, Dd^Vdr, Mdd, Mdd, Mdd, Hd, Dd, Hd^Em, Mdd, Mdd, Mdd, Rd, Mdd, Rd, Rd, Dd^Edpp, Dd
Dd, Ds, Ds, Dd^Esd, Dd, Hd, Hd, Hd, Hd, Hd, Hd, Hd, Dd, Dd, Dd, Dd^Esd, Dd, Dd, Dd, Dd, Dd, Hd, Mdd, Mdd, Mdd, Mdd, Mdd, Mdd, Mdd, Dd^Esd, Dd, Dd, Dd, Hd, Hd, Rd^Vdr, Hd^Es, Rd, Dd, Dd^Esd, Hd, Hd
Hd, Hhd, Hhd, Dd, Hd, Ds, Ds, Hd, Dd, Hd, Dd, Dd, Dd, Dd, Dd, Dd, Dd^Edpp, Dd, Dd, Dd, Hd, Hd^Uf, Mdd, Mdd, Mdd, Hhd^Uf, Hd, Hd, Hd^Em, Dd, Dd^Edpp, Dd, Ds, Dd, Hd, Hd, Hd, Dd, Hd, Hd, Mdd, Mdd
Hd, Hd^Uf, Hd^Ftd, Hd, Hd^Uf, Hd, Hd, Dd, Dd^Esd, Dd, Dd^Edp, Dd, Dd, Dd^Esd, Dd, Dd, Dd, Rd, Dd, Dd, Dd, Mdd, Hd, Mdd, Dd, Hd, Dd, Dd, Dd, Dd, Dd^Esd, Dd, Ds^Esd, Ds, Dd, Hd, Hd, Hd, Mdd, Hhd^Uf, Mdd, Mdd
Hd^Uf, Hd, Hhd, Hd^Vdr, Hhd, Hd^Do, Hd, Dd, Dd, Dd, Dd, Dd, Dd^Do, Dd^Esd, Dd, Dd, Rd, Re, Dd, Dd, Dd^Esd, Dd, Dd, Dd, Dd, Dd^Edpp, Dd, Dd, Dd, Dd, Dd, Ds, Dd, Dd, Hd, Hd, Hhd, Mdd, Mdd, Mdd, Mdd, Mdd
Hd, Hd, Hd, Hd^Uf, Hd, Hhd, Hd^Ftd, Hd, Dd, Dd, Dd, Dd, Dd^Esd, Dd^Esd, Rd, Rd, Hd^Ftd, Ds, Dd, Dd, Dd, Dd, Dd, Dd, Cd, Dd, Dd, Dd^Esd, Dd, Dd, Hd, Dd^Uf, Hd, Hd, Mdd, Hhd^Em, Mdd, Mdd, Mdd, Mdd, Mdd, Mdd
Dd, Dd, Dd, Hd, Dd, Hd, Hd, Hhd, Dd, Dd^Esd, Dd, Dd, Ds, Dd, Dd, Hd, Dd^Esd, Dd, Dd, Dd, Dd, Dd, Dd, Dd, Dd^Do, Dd, Dd^Vda, Dd, Gd^Fts, Hd, Hd^Do, Hd^Vda, Mdd, Mdd, Mdd, Mdd, Mdd^Xm, Mdd, Xue, Mdd, Xue, Xue
Rd, Dd^Esd, Dd, Rd, Dd^Uf, Dd, Dd^Esd, Rd, Dd, Dd, Rd, Rd, Dd, Ds, Ds, Dd, Dd, Dd, Dd, Dd, Dd, Dd, Rd^Vdt, Rd, Ds^Uf, Ds^Edpp, Ds^Em, Gs, Gd^Es, Hd, Hd^Uf, Mdd, Mdd, Mdd^Es, Mdd, Mdd^Xm, Xue, Xue, Xu, Xue, Xue, Xue
Dd, Dd^Do, Dd, Dd, Dd^Edpp, Dd, Dd^Ftd, Dd, Dd, Dd^Edpp, Dd, Dd, Dd, Ds, Dd, Dd, Dd^Edpp, Dd, Dd, Dd^Edpp, Dd^Ftd, Dd, Rd, Rb, Wwf, Wwrt, Wwt, Wwrt, Gs, Hd^Es, Mdd, Mdd, Mdd, Mdd, Mdd, Mdd, Xue, Xue, Xu, Xu, Xue, Xu
Dd^Ftd, Dd, Dd^Ftd, Dd^Esd, Dd^Ftd, Dd^Ftd, Hd^Ftd, Dd^Ftd, Dd^Ftd, Dd, Dd, Dd, Dd^Ftd, Dd, Dd, Dd, Dd, Cd, Dd, Dd^Ftd, Gs^Fts, Dd^Ftd, Rd^Edp, Dd^Ftd, Gs^Es, Wwt, Wwt, Wwrt, Gs, Rd, Rd, Mdd, Hd, Rd^Esd, Hhd, Xue, Xu, Xu, Uue^Dr, Xue, Uh^Uf, Xu
Dd^Ftd, Dd^Ftd, Dd^Ftd, Dd^Ftd, Mdd, Hd^Dr, Mdd, Dd^Ftd, Hd^Do, Dd^Ftd, Dd^Ftd, Dd^Ftd, Dd^Ftd, Dd^Ftd, Dd^Ftd, Dd, Dd, Cd, Dd, Gd^Fts, Gd^Fts, Rd, Gs, Wwrt, Wwrt, Ww^Ewf, Wwrt, Gd^Es, Dd^Vda, Hd^Do, Mdd, Hd, Mdd, Mdd, Xue, Uu, Uu, Uu^Vu, Uu, Uh, Uh, Uh
Gd^Fts, Dd^Ftd, Mdd, Mdd, Hd^Ftd, Mdd, Mdd, Mdd, Mdd, Mdd, Mdd, Hd^Ftd, Dd^Ftd, Dd^Ftd, Dd^Ftd, Dd, Dd, Dd, Dd, Dd^Ftd, Dd, Re, Gd, Wwrt, Gd^Fts, Gs, Ds^Esd, Ds^Uf, Hd, Mdd, Mdd, Mdd, Mdd^Xm, Mdd, Xue, Xu, Uh, Uu, Uu, Uue, Uue, Uh
Gd^Fts, Gd^Fts, Mdd, Hd^Ftd, Mdd, Mdd, Mdd, Mdd, Hd^Ftd, Mdd, Hd^Ftd, Hd^Ftd, Dd^Ftd, Dd^Ftd, Dd^Ftd, Dd, Ds, Ds, Dd, Dd, Rd^Esd, Dd, Dd, Dd^Ftd, Re, Re, Re, Cd^Ebn, Cd, Mdd, Mdd, Mdd, Mdd, Xue, Xuc, Xu, Uh, Uh, Xue, Uu, Uu, Uu
Gd^Fts, Gd^Fts, Hd^Ftd, Mdd, Mdd, Mdd, Hhd^Uf, Hd^Ftd, Dd^Ftd, Hd^Ftd, Dd^Ftd, Dd^Ftd, Dd^Ftd, Dd^Ftd, Dd, Dd^Esd, Ds, Ds, Re^Esd, Re, Dd, Rd, Rd, Rd, Dd^Esd, Dd, Cd^Ebn, Cd, 1 Kd, Mdd, Mdd, Mdd, Xue, Xue, Xuc, Uh^Uf, Uue, Xu, Xue, Uue, Uue, Uu
Dd^Ftd, Gd^Fts, Mdd, Mdd, Hd^Ftd, Hhd, Dd^Ftd, Dd^Ftd, Ds, Dd^Ftd, Dd^Ftd, Dd^Ftd, Dd^Ftd, Dd^Ftd, Dd, Dd, Dd, Dd, Rd, Dd^Esd, Gs, Dd, Re, Dd, Dd^Edpp, Dd^Do, Hd^Edt, Cd, Mdd, Mdd, Mdd, Xue, Xuc, Xuc, Uue, Uue, Uu, Xu, Uue, Uue, Uue, Uue
Dd^Ftd, Dd^Ftd, Dd^Ftd, Hd^Ftd, Gd^Fts, Dd^Ftd, Ds^Vdt, Ds, Dd, Dd^Ftd, Dd, Dd^Ftd, Dd, Dd, Dd^Esd, Dd, Rd, Rd, Dd, Dd, Rd^Do, Dd^Vdt, Re, Dd, Dd^Ftd, Hd, Mdd, Mdd, Mdd, Mdd, Mdd^Xm, Xue, Xuc, Uh^Dr, Uu, Uu, Uh, Uu, Xu, Uue, Uh, Uh
Gd^Fts, Gd^Fts, Dd^Ftd, Dd^Ftd, Gd^Fts, Dd^Ftd, Dd, Ds, Dd^Esd, Dd, Ds, Dd, Ds, Dd^Edpp, Dd, Dd, Re, Dd, Dd, Gs, Dd, Dd, Dd, Re, Dd, Mdd, Mdd, Mdd, Mdd, Mdd, Mdd^Xm, Xue, Xuc, Uh, Uu, Uh, Xu, Xu, Xue, Xue, Uh^Uf, Xu
Re, Gd^Fts, Dd^Esd, Dd^Ftd, Dd^Edpp, Dd, Ds, Dd, Dd, Ds, Dd, Ds, Dd, Dd, Re, Rd, Ds^Uf, Re, Dd^Vda, Dd, Dd, Dd^Edpp, Dd, Rd, Dd^Do, Hd, Hd, Mdd, Mdd, Mdd^Xm, Mdd^Xm, Xue, Xue, Xuc, Uu, Uh, Xu, Xue, Uue, Uue, Xue, Xu
Ds, Ds, Dd, Dd, Dd, Dd, Dd, Ds, Re, Dd, Re, Dd, Rd^Esd, Re, Gs, Gd^Fts, Wwrt, Gs, Wwt, Hhd^Uf, Ds, Dd, Rd, Re, Hd, Mdd, Mdd, Mdd, Mdd, Mdd, Xue, Xue, Xue, Xuc, Uu^Uf, Uu, Uu, Xu, Uue, Uue, Xue, Xu
Dd, Dd, Re, Re, Rd, Rd, Rd, Rd, Dd, Rd, Dd^Uf, Rd, Ds, Gd^Fts, Dd^Edpp, Wwrt, Wwt, Wwf, Gd^Fts, Wwrt, Ds, Re, Dd, Dd, Hd, Mdd, Mdd, Mdd, Mdd^Xm, Xue, Xue, Xue, Xuc, Xuc, Uue, Uu, Uue, Uu, Uu^Es, Uue^Vud, Xu, Xu
Rd, Rd, Ds, Ds, Dd, Dd, Ds, Dd, Hd^Uf, Dd^Esd, Dd, Dd, Cd, Dd, Gd, Gs^Uf, Wwt, Wwt, Wwt, Wwrt, Dd^Uf, Re, Rd, Dd^Edpp, Mdd, Mdd, Mdd, Mdd^Xm, Xue, Xue, Xuc, Xuc, Uue^Dr, Uue, Uue, Uue, Xue, Xu, Xue, Xu, Xu, Xu
Dd, Ds, Ds^Esd, Dd, Dd^Edpp, Hhd^Uf, Hd^Ftd, Hd^Ftd, Hd^Do, Ds, Hhd^Ftd, Dd, Dd, Dd, Re, Wwrt, Re^Vct, Wwt, Gs^Em, Gs, Gd, Hd, Hd, Re^Esd, Mdd, Mdd, Xue, Xue, Xuc, Xuc, Xuc, Urb^Vu, Urb, Ur, Uue, Uue, Uu, Xue, Qxe, Xue, Xu, Xue
Hd, Ds, Hd, Dd, Hd, Dd, Dd, Hd, Ds, Hd, Hd, Hhd, Dd^Uf, Dd^Esd, Dd, Re, Re, Wwrt, Re, Re^Vda, Mdd, Mdd, Mdd, Re, Re, Xuc, Xuc, Xuc, Uh, Xuc, Xuc, Xu, Xu, Xue, Uu, Uu, Cte^Uf, Qxe, Xu, Qxu, Uu^Uf, Xue
Hd, Hd, Hd, Hd, Hd, Dd, Dd^Esd, Dd, Dd, Ds, Hd, Hd, Dd, Dd, Dd, Dd^Ftd, Gd^Fts, Dd^Esd, Hd, Hd^Esd, Mdd, Mdd, Mdd, Xue, Xuc, Ur^Pw/o, Ur, Uue, Uue, Uh^Uf, Xuc, Xuc, Xuc, Xue, Ur, Uu, Cte, Cte, Uue, Xu, Uu, Uu
Mdd, Mdd, Mdd, Mdd, Hd, Hd, Cdr^Ftd, Dd, Cdr^Fet, Dd, Cdr, Hd^Ftd, Dd, Dd^Ftd, Dd^Esd, Dd, Ds, Hd, Mdd, Mdd, Mdd, Mdd, Xue, Xue, Xuc, Urb, Urb, Urb, Urb, Uu, Uu^Dr, Uh, Ur, Ur^Vu, Ur, Uu, Urb, Xu, Uue, Uue, Uue, Urb
Mdd, Mdd, Mdd, Mdd, Mdd, Hd, Hd, Hd^Uf, Cdr^Ftd, Kdr^Uf, Hd^Uf, Dd, Dd^Vdr, Ds, Dd, Hd, Hd, Hd, Mdd, Mdd, Xue, Xue, Xuc, Xuc, Urb, Ur, Uh, Uu^Uf, Uh, Ur, Ur, Urb, Urb, Uu, Xue, Uu^Uf, Uue, Uue, Ur, Ur, Uue, Ur
Mdd^Xm, Mdd, Mdd, Mdd, Mdd, Mdd^Vdr, Mdd, Hd, Mdd, Hd, Hd, Cdr^Ftd, Hd, Ds, Cdr^Ft, Hd, Hd, Mdd, Mdd, Mdd, Xue, Xue, Xuc, Urb, Xu, Xu, Xu, Xu, Uh, Uu, Uh, Ur, Uh, Xu, Xu, Uu, Uu, Uu, Uu, Uue, Uue, Uu
Mdd^Xm, Mdd^Xm, Mdd, Mdd, Mdd, Mdd, Mdd, Mdd, Mdd, Mdd, Mdd^Vhhr, Mdd, Mdd, Hd, Hd, Hd, Hd, Mdd, Mdd, Xue, Xue, Xue, Xu, Ur, Uh, Xu, Xu, Xu, Uh, Uh, Uue, Urb, Urb, Uh, Uh^Dr, Uh, Uue, Uu, Uu, Uue, Urb, Xu
Mdd^Xm, Mdd^Xm, Mdd, Mdd, Mdd, Mdd, Mdd, Mdd, Mdd, Mdd, Mdd, Mdd, Mdd, Mdd, Mdd, Hd^Uf, Mdd, Mdd, Xue, Xue, Xu, Xu, Urb^Vu, Ur, Xuc, Uh, Uue, Uh, Uu, Uu, Uu^Uf, Uue, Uu, Ur, Uue, Uue, Uu^Uf, Uu, Uue, Urb, Xu, Xu
Mdd, Mdd, Mdd^Xm, Mdd, Mdd, Mdd, Mdd^Xm, Mdd, Mdd^Xm, Mdd, Mdd, Mdd, Mdd, Mdd, Mdd^Xm, Mdd, Mdd, Mdd, Xue, Xu, Xu, Xu, Uh^Uf, Uh, Xuc, Urb, Urb, Uue, Xu, Xu, Xu, Xu, Xu, Urb^Es, Xu, Uu^Uf, Xu, Xu, Xu, Uue, Xu, Xu
Mdd^Xm, Mdd, Mdd, Mdd, Mdd, Mdd, Mdd^Xm, Mdd^Xm, Mdd, Mdd^Xm, Mdd, Mdd^Xm, Mdd, Mdd, Mdd^Xm, Mdd, Mdd, Xue, Xue, Xu, Xu, Xu, Xu, Uh, Xuc, Xuc, Uh^Uf, Urb, Ur, Xu, Xu, Xu, Xu, Qxu^Bh|, Xu, Xu, Xu, Xu, Xu, Xu, Xu, Xu
Mdd^Xm, Mdd^Xm, Mdd^Xm, Mdd^Xm, Mdd, Mdd, Mdd, Mdd, Mdd, Mdd, Mdd, Mdd, Mdd, Mdd, Mdd, Mdd, Xue, Xue, Xue, Xu, Xu, Xu, Xu, Xu, Xu, Xu, Xu, Xu, Ur, Xu, Xu, Xu, Xu, Ur, Uu, Xu, Xu, Xu, Xu, Xu, Xu, Xu
