Dd, Dd, Dd, Dd, Dd, Dd, Dd, Dd, Dd, Dd, Dd, Dd, Dd, Dd, Dd, Dd, Dd, Dd, Dd, Dd, Dd, Dd
Dd, Dd, Dd, Dd, Dd^Esd, Dd, Dd^Em, Dd, Dd, Dd, Dd^Es, Dd, Dd, Dd, Dd, Dd, Dd, Dd, Dd, Dd, Dd^Em, Dd
Dd, Dd, Dd^Dc, Dd, Dd^Es, Dd, Dd, Dd, Dd^Esd, Dd, Dd, Dd^Es, Dd, Dd, Dd, Dd^Es, Dd, Dd^Es, Dd^Dc, Dd, Dd, Dd
Dd, Dd, Dd, Dd, Dd, Dd, Dd, Dd^Esd, Dd, Dd, Mdd, Dd, Dd, Dd, Dd^Dc, Dd, Dd, Dd, Dd, Dd, Dd, Dd
Dd, Dd^Esd, Dd, Dd, Dd, Dd, Dd, Dd, Dd^Esd, Mdd, Mdd, Mdd, Mdd, Dd, Dd, Dd, Dd, Dd^Es, Dd, Dd, Dd^Em, Dd
Dd, Dd, Dd, Dd^Esd, Dd, Dd^Esd, Dd, Dd, Hd, Mdd, Mdd, Mdd, Mdd, Mdd, Mdd, Dd, Dd, Dd, Dd^Esd, Dd, Dd, Dd
Dd, Dd, Dd^Es, Dd, Dd, Dd, Dd, Dd^Esd, Dd, Hd, Hd^Ftd, Mdd, Mdd, Mdd, Hd, Dd, Dd, Dd^Es, Dd, Dd, Dd, Dd
Dd, Dd, Dd, Dd, Dd^Esd, Dd, Dd, Dd^Esd, Dd^Es, Hd^Efm, Hd^Ftd, Dd^Do, Hd^Ftd, Hd^Efm, Hd, Dd, Dd, Dd, Dd, Dd, Dd, Dd
Dd, Dd, Dd, Dd, Dd, Dd, Dd, Dd, Dd, Hd, Dd^Em, Hd^Ftd, Dd^Efm, Hd, Dd, Dd, Dd^Es, Dd, Dd, Dd^Esd, Dd, Dd
Dd, Dd, Dd, Dd^Es, Dd^Esd, Dd, Dd, Dd, Dd^Dc, Dd^Esd, Dd^Es, Dd, Dd, Dd^Esd, Dd, Dd, Dd^Esd, Dd, Dd, Dd^Dc, Dd, Dd
Dd, Dd, Dd^Em, Dd, Dd, Dd, Dd, Dd, Dd, Dd, Dd, Dd, Dd, Dd, Dd, Dd, Dd, Dd, Dd, Dd, Dd, Dd
Dd, Dd, Dd, Dd, Dd, Dd, Dd, Dd, Dd, Dd, Dd, Dd, Dd^Es, Dd, Dd, Dd, Dd, Dd, Dd, Dd, Dd, Dd
