Xzg, Xzg, Xzg, Xzg, Xzg, Xzg, Xzgg, Ket, Dd, Dd, Ds, Xoc, Iwr, Iwr, Iwr, Xoc, Ds, Dd, Ds, Ds, Ds, Ds, XUrb, XUrb, XUrb, Ds, Ds, Ds, Ds, Xoc, Iwr, Iwr, Iwr, Iwr, Iwr, Iwr, Iwr, Gll, Iwr, Xoc, Ds, Ds, Ds, Ds, XUrb, XUrb, XUrb, Ds, Ds, Ds, Dd, Dd, Dd, Ds, Ds, Ds, Ket, Dd, Dd, Dd, Dd, Dd
Xzg, Xzg, Xzg, Xzg, Xzg, Xzg, Xzgg, Ket, Dd, Dd, Ds, Xoc, Iwr, Iwr, Iwr, Xoc, Ds, Dd, Ds, Ds, Xoc, Xoc, Xoc, XUrb, XUrb, XUrb, XUrb, Dd, Dd, Xoc, Xoc, Iwr, Iwr, Iwr, Iwr, Iwr, Iwr, Iwr, Xoc, Xoc, Ds, Ds, XUrb, XUrb, XUrb, XUrb, Ds, Dd, Dd, Ds, Dd, Dd, Dd, Dd, Ds, Ds, Ket, Dd, Dd, Dd, Dd, Dd
Dd, Xzg, Xzg, Xzg, Xzg, Xzg, Xzgg, Ket, Ket, Dd, Ds, Xoc, Xoc, Iwr, Iwr, Xoc, Ds, Ds, Ds^Ftp, Xoc, Iwr, Iwr, Iwr, Rr^Pw\, Xoc, XUrb, XUrb, XUrb, XUrb, Dd, Dd, Xoc, Xoc, Iwr, Iwr, Iwr, Xoc, Rr^Pw/, Dd, Ds, XUrb, XUrb, XUrb, XUrb, Ds, Dd, Xoc, Ds^Ftp, Ds^Ftp, Dd, Dd, Dd, Ds, Dd, Ds, Ds, Ket, Dd, Dd, Dd, Dd, Dd
Dd, Dd, Dd, Xzg, Xzg, Xzg, Xzg, Xzgg, Ket, Ds, Ds, Ds, Ds^Ftp, Xoc, Xoc, Xoc, Ds, Ds, Ds^Ftp, Xoc, Xoc, Iwr, Iwr, Iwr, Iwr, Xoc, Dd^Ft, XUrb, XUrb, XUrb, XUrb, Ds^Ft, Ds, Xoc, Xoc, Xoc, Ds, Dd, XUrb, XUrb, XUrb, XUrb, Dd, Dd, Rr^Pw/, Xoc, Iwr, Xoc, Xoc, Ds^Ftp, Ds, Ds, Ds, Ds, Ket, Ket, Dd, Dd, Dd, Dd, Dd, Dd
Dd, Dd, Dd, Xzg, Xzg, Xzg^Esd, Xzg, Xzgg, Xzgg, Ket, Ket, Ds, Ds, Ds^Ftp, Dd^Ftp, Ds^Ftp, Ds, Ds, Dd, Ds^Ftp, Dd, Xoc, Xoc, Iwr, Xoc, Xoc, Dd^Ft, Ds, Ds, XUrb, XUrb, XUrb, XUrb, Ds, Ds, Ds, XUrb, XUrb, XUrb, XUrb, Ds, Ds, Xoc, Xoc, Iwr, Iwr, Iwr, Iwr, Iwr, Xoc, Xoc, Dd, Dd, Ket, Dd, Dd, Dd, Dd^Esd, Dd, Dd, Dd, Dd
Dd, Dd, Dd, Dd, Xzg, Xzg^Esd, Xzg^Esd, Xzg, Xzg, Xzgg, Ket, Ds, Ds, Dd, Dd, Dd, Dd, Ds, Dd, Ds, Dd, Dd^Ftp, Dd^Ftp, Xoc, Ds, Dd, Ds, Ds, Ds, Ds, Ds, XUrb, XUrb, XUrb, XUrb, XUrb, XUrb, XUrb, Ds, Ds, Ds^Ftp, Xoc, Iwr, Iwr, Iwr, Iwr, Iwr, Iwr, Xoc, Xoc, Dd, Dd, Ket, Ket, Dd, Dd, Dd, Dd, Dd, Dd, Dd, Dd
Dd, Dd, Dd, Dd, Dd, Xzg, Xzg, Xzg^Esd, Xzg, Xzgg, Xzgg, Ket, Ket, Ds, Ds, Dd, Dd, Dd, Ds, Ds, Ds, Ds, Ds, Ds, Dd, Ds, Dd, Ds, Dd, Ds, Dd, Ds, Ds^Ftp, XUrb, XUrb, XUrb, Ds^Ftp, Ds, Dd, Ds, Ds^Ftp, Xoc, Xoc, Iwr, Iwr, Iwr, Xoc, Xoc, Dd, Dd, Ds, Ket, Dd, Dd, Dd, Dd, Dd, Dd, Dd, Dd, Dd, Dd
XUrb, Dd, Dd, Dd, Dd, Dd, Xzg, Xzg^Esd, Xzg, Xzg, Xzg, Xzgg, Xzgg, Ket, Ket, Ds, Ds, Ds, Ds, Ds, Ds, Ds, Ds, Ds, Dd, Dd, Dd, Dd, Dd, Dd, Ds, Ds, Ds^Ftp, XUrb, XUrb, XUrb, Ds^Ftp, Dd, Dd, Ds, Dd, Ds^Ftp, Ds^Ftp, Xoc, Xoc, Xoc, Ds, Dd, Dd, Ds, Ket, Ket, Dd, Dd, Dd, Dd, Dd, Dd, Dd, Dd, Dd, Dd
Dd, XUrb, XUrb, Dd, Dd, Dd, Xzg, Xzg, Xzg^Esd, Xzg, Xzg, Xzg, Xzg, Xzgg, Ket, Ds, Ds, Ds, Ket, Ket, Ket, Ds, Ds, Ds, Ds, Dd, Dd, Dd, Dd, Dd, Ds, Ds, Ds^Ftp, XUrb, XUrb, XUrb, Ds^Ftp, Dd, Dd, Dd, Ds, Dd, Dd, Ds, Dd, Dd, Ds, Ds, Ket, Ket, Dd, Dd, Dd, Dd, Dd, Dd, Dd, Dd, Dd^Esd, Dd, Dd, Dd
Dd, Dd, XUrb, Dd, Dd, Dd, Xzg, Xzg, Xzg^Esd, Xzg^Esd, Xzg^Esd, Xzg, Xzg, Dd, Dd, Ket, Ket, Ket, Ket, Ket, Ket, Ket, Ket, Ds, Ds, Ds, Ds, Dd, Ds, Dd, Ds, Ds, Ds, XUrb, XUrb, XUrb, Ds, Dd, Ket, Ds, Ds, Dd, Dd, Dd, Ds, Dd, Ket, Ket, Ket, Dd, Dd, Dd, Dd, Dd, Dd, Dd, Dd, Dd, Dd, Dd, Dd, Dd
Dd, Dd, XUrb, Dd, Dd, Dd, Xzg, Xzg, Xzg^Esd, Xzg^Esd, Xzg^Esd, Xzg^Esd, Xzg, Dd, Dd, Dd, Dd, Dd, Dd, Dd, Dd, Dd, Ket, Dd, Dd, Ds, Dd, Dd, Dd, Ds, Ket, Ds, Ds, XUrb, XUrb, XUrb, Dd, Ket, Ket, Ket, Dd, Ds, Dd, Dd, Ket, Ket, Ket, Ket, Dd, Dd, Dd, Dd, Dd, Dd, Dd, Dd, Dd, Dd, Dd, Dd, Dd, Dd
Xzg, Dd, Dd, XUrb, Xzg^Bh\, Xzg, Xzg, Xzg^Esd, Xzg, Xzg^Esd, Xzg, Xzg^Esd, Xzg, Dd, Dd, Dd, Dd, Dd, Dd, Dd, Dd, Dd, Dd, Ket, Ket, Dd, Dd, Dd, Dd, Ket, Ket, Ket, Dd, XUrb, XUrb, XUrb, Dd, Ket, Ket, Ket, Dd, Dd, Ket, Ket, Ket, Ket, Dd, Dd, Dd, Dd, Dd, Dd, Dd, Dd, Dd, Dd, Dd, Dd^Esd, Dd, Dd, Dd, Dd
Xzg^Esd, Xzg, Xzg^Esd, Xzg, Xzg, XUrb, Xzg^Bh\, Xzg, Dd, Xzg, Dd, Xzg, Dd, Dd, Dd, Dd, Dd, Dd, Dd, Dd, Dd, Dd, Dd, Dd, Dd, Ket, Ket, Dd, Dd, Ket, Ket, Ket, Dd, XUrb, XUrb, XUrb, Dd, Dd, Dd, Ket, Ket, Ket, Dd, Dd, Dd, Dd, Dd, Dd, Dd, Dd, Dd, Dd, Dd, Dd^Edpp, Dd, Dd, Dd, Dd, Dd, Dd, Dd, Dd
Xzg, Xzg^Esd, Xzg, Xzg^Esd, Xzg, Xzg, Dd, XUrb, XUrb, Dd, Dd, Dd, Dd, Dd, Dd, Dd, Dd, Dd, Dd, Dd, Dd, Dd, Dd, Dd, Dd, Dd, Dd, Ket, Ket, Ket, Dd, Dd, Dd, XUrb, XUrb, XUrb, Dd, Dd, Dd, Dd, Dd, Dd, Dd, Dd, Dd, Dd, Dd, Dd, Dd^Esd, Dd, Dd, Dd, Dd, Dd, Dd, Dd, Dd^Esd, Dd, Dd, Dd, Dd, Dd
Dd, Xzg, Dd, Dd, Dd, Dd, Dd, Dd, XUrb, Dd, Dd, Dd, Dd, Dd, Dd, Dd^Edpp, Dd, Dd, Dd, Dd, Dd, Dd, Dd, Dd, Dd, Dd, Dd, Dd, Dd, Dd, Dd, Dd, Dd, XUrb, XUrb, XUrb, Dd, Dd, Dd, Dd, Dd, Dd, Dd^Esd, Dd, Dd, Dd, Dd, Dd, Dd, Dd, Dd, Dd, Dd, Dd, Dd, Dd, Dd, Dd, Dd, Dd, Dd, Dd
Dd, Dd, Dd, Dd, Dd, Dd, Dd, Dd, XUrb, Dd, Dd, Dd, Dd, Dd, Dd, Dd, Dd, Dd, Dd, Dd, Dd, Dd^Edpp, Dd, Dd, Dd, Dd, Dd, Dd, Dd, Dd, Dd, Dd, XUrb, XUrb, XUrb, XUrb, XUrb, Dd, Dd, Dd, Dd, Dd, Dd, Dd, Dd, Dd, Dd, Dd, Dd, Dd^Edpp, Dd, Dd, Dd, Dd, Dd, Dd, Dd, Dd^Esd, Dd, Dd, Dd, Dd
XUrb, XUrb, XUrb, Dd, Dd, Dd, XUrb, XUrb, XUrb, XUrb, XUrb, Dd, XUrb, Dd, Dd, Dd, Dd, Dd, Dd, Dd, Dd, Dd, Dd, Dd, Dd, Dd, Dd, Dd, Dd, Dd, XUrb, XUrb, XUrb, XUrb, XUrb, XUrb, XUrb, XUrb, XUrb, Dd, Dd, Dd, Dd, Dd, Dd, Dd, Dd, Dd, Dd, Dd, Dd, Dd, Dd, Dd, Dd, Dd, Dd, Dd, Dd, Dd, Dd, Dd
XUrb, XUrb, XUrb, XUrb, XUrb, XUrb, XUrb, XUrb, XUrb, XUrb, XUrb, XUrb, XUrb, XUrb, XUrb, Dd, Dd, Dd, Dd, Dd, Dd, Dd, Dd, Dd, Dd, Dd, Dd, Dd, Dd, Dd, XUrb, XUrb, XUrb, XUrb, XUrb, XUrb, XUrb, XUrb, XUrb, Dd, Dd, Dd, Dd, Dd, Dd, Dd, Dd, Dd, Dd, Dd, XUrb, Dd, Dd, Dd, Dd, Dd, Dd, Dd, Dd, Dd, Dd, Dd
Dd, XUrb, XUrb, XUrb, XUrb, XUrb, XUrb, XUrb, XUrb, XUrb, XUrb, XUrb, XUrb, XUrb, XUrb, XUrb, XUrb, XUrb, XUrb, XUrb, XUrb, XUrb, XUrb, XUrb, XUrb, XUrb, XUrb, Dd, XUrb, XUrb, XUrb, XUrb, XUrb, XUrb, XUrb, XUrb, XUrb, XUrb, XUrb, XUrb, XUrb, Dd, XUrb, XUrb, XUrb, Dd, XUrb, XUrb, XUrb, XUrb, XUrb, XUrb, XUrb, Dd, XUrb, Dd, XUrb, Dd, XUrb, XUrb, XUrb, XUrb
Dd, Dd, Dd, XUrb, XUrb, XUrb, Dd, Dd, Dd, XUrb, XUrb, XUrb, XUrb, XUrb, XUrb, XUrb, XUrb, XUrb, XUrb, XUrb, XUrb, XUrb, XUrb, XUrb, XUrb, XUrb, XUrb, XUrb, XUrb, XUrb, XUrb, XUrb, XUrb, XUrb, XUrb, XUrb, XUrb, XUrb, XUrb, XUrb, XUrb, XUrb, XUrb, XUrb, XUrb, XUrb, XUrb, XUrb, XUrb, XUrb, XUrb, XUrb, XUrb, XUrb, XUrb, XUrb, XUrb, XUrb, XUrb, XUrb, XUrb, XUrb
Dd, Dd, Dd, Dd, Dd, Dd, Dd, Dd, Dd, Dd, Dd, Dd, Dd, XUrb, Dd, XUrb, XUrb, XUrb, XUrb, XUrb, XUrb, XUrb, Dd, XUrb, XUrb, XUrb, XUrb, XUrb, XUrb, XUrb, XUrb, XUrb, XUrb, XUrb, XUrb, XUrb, XUrb, XUrb, XUrb, XUrb, XUrb, XUrb, XUrb, XUrb, Dd, XUrb, XUrb, XUrb, Dd, XUrb, Dd, XUrb, Dd, XUrb, XUrb, XUrb, XUrb, XUrb, XUrb, XUrb, XUrb, XUrb
Dd, Dd, Dd, Dd, Dd, Dd, Dd, Dd, Dd, Dd, Dd, Dd, Dd, Dd, Dd, Dd, Dd, XUrb, Dd, Dd, Dd, Dd, Dd, Dd, Dd, Dd, Dd, Dd, Dd, Dd, Dd, XUrb, Dd, Dd, Dd, XUrb, Dd, Dd, Dd, Dd, Dd, Dd, Dd, Dd, Dd, Dd, Dd^Edp, Dd, Dd, Dd, Dd, Dd, Dd, Dd, Dd, Dd, Dd, Dd, Dd, Dd, Dd, Dd
Dd, Dd, Dd, Dd, Dd, Dd, Dd, Dd, Dd, Dd^Edpp, Dd, Dd, Dd, Dd, Dd, Dd, Dd, Dd, Dd, Dd, Dd, Dd, Dd, Dd, Dd, Dd, Dd, Dd, Dd, Dd, Dd, Dd, Dd, Dd, Dd, Dd, Dd, Dd, Dd, Dd, Dd, Dd, Dd, Dd, Dd, Dd, Dd, Dd, Dd, Dd, Dd, Dd, Dd, Dd, Dd, Dd, Dd, Dd, Dd, Dd, Dd, Dd
Dd, Dd, Dd, Dd, Dd^Edpp, Dd, Dd, Dd, Dd, Dd, Dd, Dd, Dd, Dd, Dd, Dd, Dd, Dd, Dd, Dd, Dd, Dd, Dd, Dd, Dd, Dd, Dd^Edpp, Dd, Dd, Dd, Dd, Dd, Dd, Dd, Dd, Dd, Dd, Dd, Dd, Dd, Dd, Dd, Dd, Dd, Dd, Dd, Dd, Dd, Dd, Dd, Dd, Dd, Dd, Dd, Dd, Dd, Dd, Dd^Edpp, Dd, Dd, Dd, Dd
Dd, Dd, Dd, Dd, Dd, Dd, Dd, Dd, Dd, Dd, Dd, Dd, Dd, Dd, Dd, Dd, Dd^Edpp, Dd, Dd, Dd, Dd, Dd, Dd, Dd, Dd, Dd, Dd, Dd, Dd, Dd, Dd, Dd, Dd, Dd^Edpp, Dd, Dd, Dd, Dd, Dd, Dd^Edp, Dd, Dd, Dd, Dd, Dd, Dd, Dd^Edp, Dd, Dd, Dd, Dd, Dd, Dd, Dd, Dd, Dd, Dd, Dd, Dd, Dd, Dd, Dd
Dd, Dd, Dd, Dd, Dd, Dd, Dd, Dd, Dd, Dd, Dd, Dd, Dd, Dd, Dd, Dd, Dd, Dd, Dd, Dd, Dd, Dd, Dd, Dd, Dd, Dd, Dd, Dd, Dd, Dd, Dd, Dd, Dd, Dd, Dd, Dd, Dd, Dd, Dd, Dd, Dd, Dd, Dd, Dd, Dd, Dd, Dd, Dd, Dd, Dd, Dd, Dd, Dd, Dd, Dd, Dd, Dd, Dd, Dd, Dd, Dd, Dd
Dd, Dd, Dd, Dd, Dd, Dd, Dd, Dd, Dd, Dd, Dd, Dd, Dd, Dd, Dd, Dd, Dd, Dd, Dd, Dd, Dd, Dd, Dd, Dd, Dd, Dd, Dd, Dd, Dd, Dd, Dd, Dd, Dd, Dd, Dd, Dd, Dd, Dd, Dd, Dd, Dd, Dd, Dd, Dd, Dd, Dd, Dd, Dd, Dd, Dd, Dd, Dd, Dd, Dd, Dd, Dd, Dd, Dd, Dd, Dd, Dd, Dd
