Dd, Wwf, Wwf, Dd, Dd, Dd, Dd, Dd, Dd^Ftd, Dd^Ftd, Dd^Ftd, Dd^Ftd, Dd^Ftd, Dd^Ftd, Dd^Ftd, Dd^Ftd, Wwt, Wwt, Wwt, Wwt, Dd^Ftd, Dd^Ftd, Dd^Ftd, Dd^Ftd
Dd, Dd, Dd, Wwf, Wwf, Dd, Dd, Dd, Dd, Dd^Ftd, Dd^Ftd, Dd^Ftd, Dd^Ftd, Dd^Ftd, Wwt, Wwt, Wwt, Wwt, Wwt, Wwt, Dd^Ftd, Dd^Ftd, Dd^Ftd, Dd^Ftd
Dd, Dd, Mm, Dd, Wwf, Dd, Dd, Dd, Wwt, Dd, Dd, Wwt, Wwt, Wwt, Dd, Wwt, Dd^Ftd, Dd^Ftd, Dd^Ftd, Dd^Ftd, Dd^Ftd, Dd^Ftd, Dd^Ftd, Dd^Ftd
Dd, Dd, Dd, Dd, Dd, Wwf, Wwf, Dd, Wwt, Wwt, Wwt, Wwt, Dd, Dd, Dd, Dd, Dd, Dd^Ftd, Dd^Ftd, Dd^Ftd, Dd^Ftd, Dd^Ftd, Dd^Ftd, Dd^Ftd
Dd, Dd, Dd^Eff, Dd, Dd, Dd, Dd, Wwf, Dd, Dd, Dd, Dd, Dd, Dd, Dd^Efm, Dd, Dd, Dd^Ftd, Dd^Ftd, Dd^Ftd, Dd^Ftd, Dd^Ftd, Gs^Ftp, Gs^Ftp
Dd^Eff, Dd^Eff, Dd, Dd^Eff, Dd^Eff, Dd, Dd^Efm, Wwf, Wwf, Ds, Dd, Dd, Dd^Efm, Dd^Efm, Dd, Dd, Dd, Dd^Ftd, Dd, Dd^Ftd, Dd^Ftd, Dd^Ftd, Dd^Ftd, Gs^Ftp
Dd, Dd, Dd, Dd, Dd, Dd^Eff, Dd^Eff, Dd, Wwf, Ds, Dd^Efm, Dd, Dd, Dd, Dd^Efm, Dd, Dd^Efm, Dd, Dd, Dd, Dd, Dd^Ftd, Dd^Ftd, Dd^Ftd
Wwf, Dd, Dd, Dd, Dd, Dd, Dd, Dd^Eff, Dd^Eff, Wwf, Wwf, Dd^Efm, Dd, Dd, Dd, Dd, Dd^Efm, Dd, Dd^Efm, Dd^Efm, Dd^Ftd, Dd^Ftd, Dd^Ftd, Dd^Ftd
Dd, Wwf, Wwf, Dd^Efm, Dd, Dd, Dd^Efm, Dd^Efm, Dd, Dd^Eff, Wwf^Eff, Dd, Dd, Dd, Dd^Efm, Dd, Dd, Dd, Dd, Dd, Dd, Dd^Ftd, Dd^Efm, Dd^Ftd
Dd, Dd, Dd, Wwf, Wwf, Dd, Dd, Dd, Wwf, Wwf, Wwf, Wwf^Eff, Wwf^Eff, Ds, Ds, Dd, Dd, Dd, Dd^Efm, Dd, Dd, Dd, Dd, Dd
Dd^Eff, Dd, Dd, Dd^Efm, Dd, Wwf, Wwf, Wwf, Dd, Dd, Ds, Wwf, Wwf, Wwf^Eff, Wwf^Eff, Dd, Wwf, Dd, Dd, Dd^Efm, Dd, Ds, Wwt, Wot
Dd, Dd^Eff, Dd^Eff, Dd, Dd, Dd, Dd, Dd, Dd, Dd, Dd, Ds, Dd^Eff, Wwf^Eff, Wwf, Wwt, Wwt, Wwt, Wwt, Ds, Wwt, Wwt, Wwt, Wot
Dd, Dd^Emf, Dd^Emf, Dd^Eff, Dd^Eff, Dd, Dd, Dd^Efm, Dd, Dd, Dd^Eff, Dd^Eff, Dd, Dd, Ds, Wwf, Ds, Wwt, Wwt, Wwt, Wwt, Wwt, Dd^Efm, Dd
Dd, Dd^Emf, Dd^Efm, Dd^Efm, Dd^Efm, Dd^Eff, Dd^Eff, Dd, Dd^Eff, Dd^Eff, Dd, Dd, Dd, Dd, Ds, Ds, Wwt, Ds, Wwt, Wwt, Wwt, Ds, Dd, Dd
Dd, Dd^Efm, Dd^Efm, Dd^Efm, Dd^Gvs, Dd^Gvs, Dd^Eff, Dd^Eff, Dd, Dd, Dd, Dd, Wwf, Wwf, Wwf, Wwf, Ds, Wwt, Dd, Ds, Dd, Wwt, Dd, Dd
Dd^Efm, Dd^Efm, Dd^Gvs, Dd^Gvs, Dd^Eff, Dd^Eff, Dd, Wwf, Wwf, Wwf, Wwf, Wwf, Dd, Ds, Dd, Dd, Dd^Efm, Dd, Dd, Dd, Dd, Wwt, Wwt, Dd
Dd, Dd^Gvs, Xom, Dd^Eff, Wwf, Wwf, Wwf, Wwf, Ds, Ds, Dd, Dd^Efm, Dd^Dc, Dd, Dd^Efm, Dd^Es, Dd, Dd, Dd, Dd^Efm, Dd, Dd^Es, Dd, Wwt
Xom, Xom, Wot, Xom, Xom^Efs, Xom, Xom, Dd, Dd^Efm, Dd^Efm, Dd, Dd, Dd, Dd, Dd, Dd, Dd, Dd^Efm, Dd, Dd, Dd, Dd, Dd^Efm, Dd
Xom, Iwr, Rr^Pw/, Xom, Iwr^Efs, Iwr^Enz, Iwr, Xom^Efs, Rr^Pw\, Dd, Dd, Dd, Dd, Dd, Dd, Dd, Dd, Dd, Dd^Efm, Dd, Dd, Dd, Dd, Dd
Xom, Xom, Iwr^Ejz, Icn, Icn, Iwr, Icn, Icn, Xom, Xom, Dd^Eff, Dd^Eff, Dd^Eff, Dd, Dd, Dd, Dd, Dd, Dd, Dd, Dd, Dd, Dd, Dd
Xom, Xoi, Xoi, Iwr^Egz, Iwr, Icn, Iwr, Iwr^Eqy, Xom, Dd^Ewz, Dd^Gvs, Dd^Gvs, Dd^Gvs, Dd^Eff, Dd^Eff, Dd, Dd, Dd, Dd, Dd, Dd^Dc, Dd, Dd, Dd
Xom, Iwr^Eky, Icn, Xom^Efs, Rr^Pw\, Icn, Iwr, Iwr, Xom, Dd^Gvs, Dd^Gvs, Dd^Gvs, Dd^Gvs, Dd^Gvs, Dd^Gvs, Dd^Eff, Dd^Eff, Dd, Dd, Dd^Es, Dd, Dd, Dd, Dd
Xom, Iwr^Eb, Iwr, Icn, Iwr^Eaz, Xom, Iwr^Eqy, Iwr, Xom, Dd^Gvs, Dd^Gvs, Dd^Gvs, Dd^Gvs, Dd^Gvs, Dd^Eff, Dd^Eff, Dd, Dd, Dd, Dd, Dd, Dd, Dd, Dd
Xom, Xom, Xom, Xom, Xom, Xom, Xom, Xom, Xom, Dd^Gvs, Dd, Dd^Gvs, Dd, Dd^Eff, Dd, Dd, Dd, Dd, Dd, Dd, Dd, Dd, Dd, Dd
