Dd^Ftd, Dd^Ftd, Dd^Ftd, Dd^Ftd, Dd, Dd, Dd^Efm, Dd, Dd, Dd, Wwf, Wwt, Wwt, Wwt, Wwf, Wwf, Dd, Dd, Dd, Dd, Dd, Dd, Dd, Dd
Dd^Ftd, Dd^Ftd, Dd, Dd^Efm, Dd, Dd^Efm, Dd^Efm, Dd, Dd, Dd, Wwf, Wwt, Wwt, Wwt, Wwf, Wwf, Dd, Dd^Em, Dd, Dd^Em, Dd, Dd^Efm, Dd^Efm, Dd
Dd^Ftd, Dd^Ftd, Dd^Ftd, Dd, Dd^Efm, Dd^Efm, Dd^Efm, Dd^Efm, Dd^Efm, Dd, Wwf, Wwt, Wwt, Wwt, Wwf, Wwf, Dd, Dd^Efm, Dd^Efm, Dd^Efm, Dd^Efm, Dd^Em, Dd, Dd
Dd^Ftd, Dd^Ftd, Dd^Ftd, Dd^Ftd, Dd^Efm, Dd^Efm, Dd, Dd^Efm, Dd, Dd, Wwf, Wwt, Wwt, Wwf, Wwf, Wwf, Wwf, Dd, Wwf, Dd^Efm, Wwf, Dd, Wwf, Wwf
Wwf, Dd^Ftd, Dd, Dd^Ftd, Dd, Dd^Efm, Dd, Dd, Wwf, Wwf, Wwf, Wwt, Wwt, Wwf, Wwf, Wwf, Wwf, Wwf, Wwf, Wwf, Wwf, Wwf, Wwf, Xos
Wwf, Wwf, Wwf, Dd, Wwf, Wwf, Wwf, Wwf, Dd, Dd, Wwf, Wwt, Wwt, Wwf, Wwf, Dd, Dd^Em, Dd, Dd^Em, Dd, Xos, Wwf, Wwf, Wwf
Dd^Ftd, Wwf, Wwf, Wwf, Wwf, Wwf, Dd^Efm, Dd, Dd^Efm, Wwf, Wwf, Wwt, Wwt, Wwf, Wwf, Dd, Dd, Dd, Xos, Xos, Wwf, Wwf, Wwf, Wwf
Xos, Dd^Ftd, Wwf, Wwf, Dd^Em, Dd^Efm, Dd^Efm, Dd^Efm, Dd^Em, Dd, Wwf, Wwt, Wwf, Wwf, Wwf, Dd^Efm, Dd, Xos, Wwf, Wwf, Wwf, Wwf, Wwf, Wwf
Wwf, Wwf, Wwf, Dd^Efm, Dd^Efm, Dd^Efm, Dd, Dd^Efm, Dd^Efm, Dd^Efm, Dd^Efm, Wwf, Wwf, Wwf, Wwf, Wwf, Dd, Xos, Wwf, Wwf, Wwf, Wwf, Wwf, Wwf
Wwf, Wwf, Wwf, Xos, Xos, Dd^Efm, Dd, Dd^Efm, Dd^Em, Dd^Em, Dd^Efm, Wwf, Wwt, Wwt, Wwf, Wwf, Wwf, Wwf, Wwf, Wwf, Xos, Wwf, Wwf, Wwf
Wwf, Wwf, Wwf, Wwf, Wwf, Xos, Xos, Dd, Dd^Efm, Dd^Efm, Dd, Wwf, Wwt, Wwt, Wwf, Wwf, Dd^Efm, Wwf, Dd^Efm, Dd^Efm, Dd^Efm, Xos, Xos, Wwf
Wwf, Wwf, Wwf, Wwf, Wwf, Wwf, Wwf, Xos, Dd, Dd, Wwf, Wwt, Wwf, Wwf, Wwf, Dd, Wwf, Dd^Efm, Dd, Dd^Efm, Dd^Efm, Dd^Efm, Dd^Efm, Xos
Xos, Wwf, Wwf, Wwf, Wwf, Wwf, Wwf, Xos, Dd^Efm, Dd, Wwf, Wwf, Dd, Wwf, Wwt, Wwf, Wwf, Wwf, Wwf, Wwf, Wwf, Dd^Efm, Dd^Em, Dd^Efm
Dd^Ftd, Xos, Xos, Wwf, Xos, Wwf, Wwf, Wwf, Wwf, Dd^Efm, Wwf, Wwf, Wwt, Wwf, Wwf, Wwt, Wwt, Wwf, Wwf, Wwf, Wwf, Wwf, Wwf, Dd^Efm
Dd^Ftd, Dd^Ftd, Dd^Ftd, Xos, Dd^Efm, Dd^Efm, Dd^Efm, Wwf, Dd^Efm, Wwf, Wwf, Wwt, Wwt, Wwf, Wwf, Wwf, Wwf, Wwf, Dd, Dd, Dd, Dd, Dd^Efm, Wwf
Wwf, Dd^Ftd, Dd^Ftd, Dd^Ftd, Dd^Efm, Dd^Efm, Wwf, Dd^Efm, Wwf, Dd^Efm, Wwf, Wwt, Wwt, Wwf, Wwf, Wwf, Dd, Dd, Dd^Efm, Dd^Efm, Dd^Efm, Dd, Dd^Efm, Dd
Wwf, Wwf, Wwf, Wwf, Wwf, Wwf, Wwf, Wwf, Wwf, Wwf, Wwf, Wwt, Wwt, Wwt, Wwf, Wwf, Dd^Efm, Dd^Efm, Dd^Efm, Dd^Efm, Dd^Efm, Dd^Em, Dd^Edpp, Dd
Dd^Ftd, Wwf, Dd^Ftd, Wwf, Dd^Ftd, Dd^Ftd, Dd^Ftd, Dd^Ftd, Wwf, Wwf, Wwt, Wwt, Wwt, Dd, Wwf, Dd, Dd^Efm, Dd^Em, Dd, Dd^Efm, Dd^Efm, Dd^Efm, Dd^Em, Dd
Dd^Ftd, Dd^Ftd, Dd^Ftd, Dd^Ftd, Dd^Ftd, Dd^Ftd, Wwf, Wwf, Wwt, Wwt, Wwt, Wwt, Wwf, Wwf, Wwf, Dd^Efm, Dd^Efm, Dd, Dd^Em, Dd, Dd^Efm, Dd, Dd^Edp, Dd
Dd^Ftd, Dd^Ftd, Dd^Ftd, Dd^Ftd, Wwf, Wwf, Wwt, Wwt, Wwt, Wwt, Wwf, Wwf, Dd^Efm, Wwf, Dd^Efm, Dd, Dd^Efm, Dd^Efm, Dd^Efm, Dd^Efm, Dd^Em, Dd^Efm, Dd^Em, Dd
Wwf, Dd^Ftd, Wwf, Wwf, Wwt, Wwt, Wwt, Wwt, Wwf, Wwf, Dd^Efm, Dd, Dd^Efm, Dd, Dd^Efm, Dd^Efm, Dd^Efm, Dd^Em, Dd^Efm, Dd^Em, Dd^Em, Dd^Efm, Dd^Efm, Dd
Wwt, Wwf, Wwt, Wwt, Wwt, Wwt, Wwf, Wwf, Dd^Ftd, Dd^Ftd, Dd, Dd^Efm, Dd^Efm, Dd^Efm, Dd^Em, Dd^Efm, Dd^Em, Dd^Efm, Dd^Efm, Dd^Em, Dd^Efm, Dd^Edp, Dd^Efm, Dd
Wwt, Wwt, Wwt, Wwt, Dd^Ftd, Wwf, Dd^Ftd, Dd^Ftd, Dd^Ftd, Dd^Ftd, Dd^Ftd, Dd, Dd^Ftd, Dd^Efm, Dd^Em, Dd, Dd^Efm, Dd, Dd^Efm, Dd^Efm, Dd^Efm, Dd^Efm, Dd^Em, Dd
Wwt, Wwt, Wwf, Wwf, Dd^Ftd, Dd^Ftd, _f, Dd^Ftd, Dd^Ftd, Dd^Ftd, Dd^Ftd, Dd^Ftd, Dd^Ftd, Dd^Ftd, Dd, Dd, Dd, Dd, Dd, Dd^Efm, Dd, Dd^Efm, Dd, Dd
