Wwf, Kte, Kte, Wwf, Wwf, Kte, Kte, Wwf, Wwf, Wwf, Wwf, Wwf, Wwf, Wwf, Wwf, Wwf, Wwf, Wwf, Kte, Kte, Wwf, Wwf, Kte, Kte
Kte, Wwf, Wwf, Kte, Kte, Wwf, Wwf, Kte, Kte, Wwf, Wwf, Wwf, Wwt, Wwf, Wwf, Wwf, Kte, Kte, Wwf, Wwf, Kte, Kte, Wwf, Wwf
Wwf, Kte, Kte, Wwf, Wwf, Kte, Kte, Wwf, Wwf, Kte, Wwt, Wwt, Kte, Wwt, Wwt, Kte, Wwf, Wwf, Kte, Kte, Wwf, Wwf, Kte, Kte
Kte, Wwf, Wwf, Kte, Kte, Wwf, Wwf, Kte, Kte, Wwt, Wwt, Wwt, Wwt, Wwt, Wwt, Wwt, Kte, Kte, Wwf, Wwf, Kte, Kte, Wwf, Wwf
Wwf, Kte, Kte, Wwf, Wwf, Kte, Kte, Wwf, Wwf, Wwt, Kte, Wwt, Km, Wwt, Kte, Wwt, Wwf, Wwf, Kte, Kte, Wwf, Wwf, Kte, Kte
Wwf, Wwf, Wwf, Kte, Kte, Wwf, Wwf, Kte, Kte, Wwt, Wwt, Wwt, Wwt, Wwt, Wwt, Wwt, Kte, Kte, Wwf, Wwf, Kte, Kte, Wwf, Wwf
Wwf, Wwf, Wwf, Wwf, Wwf, Kte, Kte, Wwf, Wwf, Wwt, Wwt, Kte, Kte, Kte, Wwt, Wwt, Wwf, Wwf, Kte, Kte, Wwf, Wwf, Wwf, Wwf
Xos, Wwf, Wwf, Wwf, Wwf, Wwf, Wwf, Kte, Kte, Wwf, Wwf, Wwt, Wwt, Wwt, Wwf, Wwf, Kte, Kte, Wwf, Wwf, Wwf, Wwf, Wwf, Wwf
Wwf, Xos, Xos, Wwf, Wwf, Wwf, Wwf, Wwf, Wwf, Wwf, Wwf, Wwt, Wwt, Wwt, Wwf, Wwf, Wwf, Wwf, Wwf, Wwf, Wwf, Wwf, Xos, Xos
Wwf, Wwf, Wwf, Xos, Xos, Wwf, Wwf, Wwf, Wwf, Wwf, Wwt, Wwt, Wwt, Wwt, Wwf, Wwf, Wwf, Wwf, Wwf, Wwf, Xos, Xos, Wwf, Wwf
Xos, Wwf, Wwf, Wwf, Wwf, Xos, Xos, Wwf, Wwf, Wwf, Wwf, Wwt, Wwt, Wwt, Wwf, Wwf, Wwf, Wwf, Xos, Xos, Wwf, Wwf, Wwf, Wwf
Hd, Xos, Xos, Wwf, Wwf, Wwf, Wwf, Wwf, Xos, Wwf, Xos, Wwt, Wwt, Wwt, Xos, Wwf, Xos, Xos, Wwf, Wwf, Wwf, Wwf, Xos, Xos
Wwf, Hd^Efm, Hd, Xos, Xos, Wwf, Wwf, Wwf, Wwf, Xos, Xos, Wwt, Wwt, Wwt, Xos, Xos, Wwf, Wwf, Wwf, Wwf, Xos, Xos, Hd^Efm, Hd
Wwf, Wwf, Wwf, Hd^Em, Hd, Xos, Hd, Wwf, Wwf, Wwf, Wwf, Wwt, Wwt, Wwt, Wwf, Wwf, Wwf, Wwf, Xos, Xos, Hd, Hd^Em, Wwf, Wwf
Wwf, Wwf, Wwf, Wwf, Wwf, Hd^Efm, Hd^Em, Xos, Xos, Wwf, Hd, Wwt, Wwt, Wwt, Xos, Wwf, Xos, Xos, Hd, Hd^Efm, Wwf, Wwf, Wwf, Wwf
Dd, Wwf, Wwf, Wwf, Wwf, Wwf, Wwf, Hd, Hd, Xos, Hd^Efm, Wwt, Wwt, Wwt, Xos, Xos, Hd^Efm, Hd, Wwf, Wwf, Wwf, Wwf, Wwf, Wwf
Dd^Efm, Dd, Dd, Wwf, Wwf, Wwf, Wwf, Wwf, Wwf, Hd, Wwf, Wwt, Wwt, Wwt, Wwt, Hd, Wwf, Wwf, Wwf, Dd, Wwf, Wwf, Dd, Dd
Dd, Dd^Efm, Dd, Wwf, Wwf, Wwf, Wwf, Wwf, Wwt, Wwf, Wwf, Wwt, Wwt, Wwt, Wwf, Wwf, Wwf, Wwf, Wwf, Wwf, Wwf, Wwf, Dd^Efm, Dd^Efm
Wwf, Dd, Wwf, Wwf, Wwt, Wwf, Wwf, Wwt, Wwt, Wwt, Wwt, Wwt, Wwt, Wwt, Wwt, Wwf, Wwf, Wwf, Wwf, Wwf, Wwf, Dd, Dd^Efm, Dd^Em
Wwt, Wwf, Wwt, Wwt, Wwf, Wwt, Wwf, Wwf, Wwf, Wwt, Wwt, Wwt, Wwt, Wwt, Wwt, Wwt, Wwt, Wwf, Wwt, Wwf, Wwf, Dd, Dd, Dd
Wwf, Wwt, Wwf, Wwf, Wwf, Wwf, Wwf, Wwf, Wwf, Wwf, Wwf, Wwt, Wwt, Wwt, Wwf, Wwt, Wwf, Wwt, Wwf, Wwt, Wwt, Wwf, Wwf, Wwf
Dd, Wwf, Dd, Dd, Dd^Em, Wwf, Wwf, Dd, Wwf, Wwf, Wwf, Wwt, Wwt, Wwt, Wwf, Wwf, Wwf, Wwf, Dd, Wwf, Wwf, Wwt, Wwt, Wwt
Dd, Dd^Em, Dd, Dd^Efm, Dd, Wwf, Wwf, Wwf, Wwf, Wwf, Wwf, Wwt, Wwt, Wwt, Wwf, Dd, Wwf, Wwf, Dd^Efm, Dd^Efm, Dd, Wwf, Wwf, Wwf
Wwf, Dd^Efm, Dd, Dd^Efm, Dd, Wwf, Wwf, Wwf, Wwf, Wwf, Wwf, Wwt, Wwt, Wwt, Wwf, Wwf, Wwf, Wwf, Wwf, Dd^Em, Dd, Dd, Dd, Dd
